"a" = (/turf/simulated/mineral,/area/space)
"b" = (/obj/effect/floor_decal/techgrid/full{dir = 1},/obj/effect/decal/cleanable/blood/gibs/body,/turf/simulated/floor,/area/shuttle/syndicate_elite/mothership)
"e" = (/turf/simulated/floor,/area/shuttle/syndicate_elite/mothership)
"f" = (/obj/effect/gibspawner/human,/turf/simulated/floor/asteroid,/area/space)
"i" = (/obj/effect/floor_decal/oldflood,/turf/simulated/floor,/area/shuttle/syndicate_elite/mothership)
"j" = (/obj/effect/decal/remains,/turf/simulated/floor/asteroid,/area/space)
"m" = (/obj/item/modular_computer/console/preset/syndicate,/turf/simulated/floor,/area/shuttle/syndicate_elite/mothership)
"t" = (/turf/simulated/floor/asteroid,/area/space)
"v" = (/obj/structure/table/steel_reinforced,/obj/item/device/radio/intercept,/obj/effect/floor_decal/techgrid/full,/obj/effect/decal/cleanable/cobweb2{dir = 4; icon_state = "cobweb1"},/turf/simulated/floor,/area/shuttle/syndicate_elite/mothership)
"x" = (/mob/living/simple_animal/hostile/syndicate/ranged/space,/obj/structure/bed/chair/shuttle/black,/turf/simulated/floor,/area/shuttle/syndicate_elite/mothership)
"z" = (/obj/machinery/light/small/hl{dir = 8},/obj/effect/floor_decal/techgrid/full{dir = 8},/obj/effect/decal/cleanable/cobweb,/turf/simulated/floor,/area/shuttle/syndicate_elite/mothership)
"B" = (/obj/item/ammo_casing/a10mm/used,/obj/item/ammo_casing/a10mm/used{pixel_x = 6; pixel_y = 9},/turf/simulated/floor/asteroid,/area/space)
"C" = (/obj/machinery/light/small/hl{dir = 4},/obj/effect/floor_decal/techgrid/full{dir = 4},/turf/simulated/floor,/area/shuttle/syndicate_elite/mothership)
"D" = (/obj/structure/table/steel_reinforced,/obj/item/ammo_magazine/a10mm,/obj/item/ammo_magazine/a10mm,/obj/item/ammo_magazine/a10mm,/obj/effect/floor_decal/techgrid/full{dir = 4},/turf/simulated/floor,/area/shuttle/syndicate_elite/mothership)
"F" = (/obj/effect/floor_decal/asteroid,/turf/simulated/floor,/area/shuttle/syndicate_elite/mothership)
"K" = (/obj/machinery/light/small/hl{dir = 4},/turf/simulated/floor,/area/shuttle/syndicate_elite/mothership)
"M" = (/obj/item/ammo_casing/a10mm/used{pixel_y = 7},/obj/item/ammo_casing/a10mm/used{pixel_x = 10; pixel_y = 11},/obj/item/ammo_casing/a10mm/used{pixel_x = 8; pixel_y = -4},/turf/simulated/floor/asteroid,/area/space)
"R" = (/obj/effect/floor_decal/asteroid,/obj/effect/floor_decal/oldflood,/turf/simulated/floor,/area/shuttle/syndicate_elite/mothership)
"U" = (/obj/structure/inflatable/door,/turf/simulated/floor/asteroid,/area/space)
"W" = (/obj/effect/floor_decal/industrial/warning/red/full,/obj/item/ammo_magazine/a10mm/empty,/turf/simulated/floor/asteroid,/area/space)

(1,1,1) = {"
aaaaBfaatt
aaaaMjaatt
aaaaaWaaat
aaaaaUaaaa
azeFibaaaa
aeieeCaaat
aRxKaaaatt
avmDaaaata
aaaaaaattt
aaaaattttt
"}
