"bq" = (/obj/structure/table/rack,/obj/item/clothing/suit/space/void/engineering/salvage/prepared,/turf/simulated/floor,/area/syndicate_mothership)
"bz" = (/obj/structure/table/rack,/obj/item/clothing/suit/space/void/engineering/salvage/prepared,/turf/simulated/floor/asteroid,/area/syndicate_mothership)
"bF" = (/obj/machinery/power/smes/buildable{RCon_tag = null; capacity = 2.5e+006; charge = 500000; cur_coils = 2; input_attempt = 1; input_level = 500000; output_attempt = 1; output_level = 500000},/turf/simulated/floor/asteroid,/area/syndicate_mothership)
"bZ" = (/obj/effect/floor_decal/rust,/turf/simulated/floor/tiled,/area/syndicate_mothership)
"cE" = (/obj/structure/firedoor_assembly,/turf/simulated/floor/asteroid,/area/syndicate_mothership)
"dr" = (/obj/effect/decal/mecha_wreckage/ripley,/turf/simulated/floor/asteroid,/area/syndicate_mothership)
"dD" = (/obj/machinery/atmospherics/pipe/tank/air{dir = 4},/turf/simulated/floor/asteroid,/area/syndicate_mothership)
"dZ" = (/turf/simulated/floor/asteroid,/area/syndicate_mothership)
"ej" = (/obj/structure/spider/stickyweb,/turf/simulated/floor/asteroid,/area/syndicate_mothership)
"en" = (/obj/machinery/power/terminal{dir = 4},/obj/structure/cable/yellow{d2 = 8; icon_state = "0-8"},/turf/simulated/floor/asteroid,/area/syndicate_mothership)
"fq" = (/obj/item/storage/toolbox/syndicate,/turf/simulated/floor/asteroid,/area/syndicate_mothership)
"gx" = (/turf/simulated/floor/grid/greengrid/airless,/area/syndicate_mothership)
"it" = (/obj/machinery/atmospherics/pipe/simple/visible/blue{dir = 9},/turf/simulated/floor/asteroid,/area/syndicate_mothership)
"iL" = (/obj/structure/flora/junglevines/heavy,/turf/simulated/floor/asteroid,/area/syndicate_mothership)
"ll" = (/obj/structure/door_assembly/door_assembly_med,/turf/simulated/floor,/area/syndicate_mothership)
"ls" = (/obj/structure/table/steel_reinforced,/turf/simulated/floor/asteroid,/area/syndicate_mothership)
"lO" = (/obj/structure/inflatable/door,/turf/simulated/floor,/area/syndicate_mothership)
"lY" = (/mob/living/simple_animal/hostile/giant_spider,/turf/simulated/floor/asteroid,/area/syndicate_mothership)
"mk" = (/obj/structure/door_assembly/door_assembly_med,/turf/simulated/floor/asteroid,/area/syndicate_mothership)
"no" = (/obj/machinery/constructable_frame,/turf/simulated/floor/asteroid,/area/syndicate_mothership)
"oq" = (/obj/structure/spider/stickyweb/sealed,/turf/simulated/floor/asteroid,/area/syndicate_mothership)
"rf" = (/obj/item/stack/medical/advanced/resurrection_serum,/obj/effect/decal/cleanable/blood/gibs/down,/turf/simulated/floor,/area/syndicate_mothership)
"rr" = (/obj/mecha/medical/odysseus/loaded,/obj/structure/curtain/medical,/turf/simulated/floor/asteroid,/area/syndicate_mothership)
"rG" = (/turf/simulated/floor/tiled,/area/syndicate_mothership)
"sg" = (/obj/structure/sign/directions/medical{dir = 8; pixel_y = -10},/turf/simulated/wall/r_wall,/area/syndicate_mothership)
"tJ" = (/obj/structure/table/steel_reinforced,/turf/simulated/floor,/area/syndicate_mothership)
"ub" = (/turf/simulated/floor/grid/bluegrid/airless,/area/syndicate_mothership)
"uq" = (/obj/item/clothing/suit/space/void/medical/alt,/obj/structure/table/rack,/turf/simulated/floor/asteroid,/area/syndicate_mothership)
"vL" = (/mob/living/simple_animal/hostile/giant_spider/viper,/turf/simulated/floor,/area/syndicate_mothership)
"vM" = (/turf/simulated/wall/r_wall,/area/syndicate_mothership)
"wP" = (/obj/structure/flora/jungleplants/glowshroom,/obj/effect/floor_decal/rust,/turf/simulated/floor,/area/syndicate_mothership)
"xr" = (/mob/living/simple_animal/hostile/asteroid/sand_lurker,/turf/simulated/floor/asteroid,/area/syndicate_mothership)
"zN" = (/obj/item/storage/box/shotgun/slugs,/turf/simulated/floor/asteroid,/area/syndicate_mothership)
"AB" = (/mob/living/simple_animal/hostile/giant_spider/hunter/flesh,/turf/simulated/floor/asteroid,/area/syndicate_mothership)
"Bp" = (/obj/machinery/portable_atmospherics/powered/scrubber/huge/stationary,/turf/simulated/floor/asteroid,/area/syndicate_mothership)
"Di" = (/obj/structure/flora/jungleplants/glowshroom,/mob/living/simple_animal/hostile/asteroid/sand_lurker,/turf/simulated/floor/asteroid,/area/syndicate_mothership)
"DU" = (/obj/structure/rock,/turf/simulated/floor/asteroid,/area/syndicate_mothership)
"Ef" = (/obj/machinery/atmospherics/pipe/simple/visible/blue{dir = 10},/turf/simulated/floor/asteroid,/area/syndicate_mothership)
"EB" = (/obj/machinery/portable_atmospherics/canister,/turf/simulated/floor/asteroid,/area/syndicate_mothership)
"Hz" = (/obj/machinery/atmospherics/pipe/simple/visible/blue{dir = 6},/turf/simulated/floor/asteroid,/area/syndicate_mothership)
"Ih" = (/obj/machinery/atmospherics/valve,/turf/simulated/floor/asteroid,/area/syndicate_mothership)
"IC" = (/obj/machinery/the_singularitygen,/turf/simulated/floor/asteroid,/area/syndicate_mothership)
"IV" = (/obj/machinery/atmospherics/pipe/simple/visible/blue,/turf/simulated/floor/asteroid,/area/syndicate_mothership)
"Jo" = (/obj/structure/flora/jungleplants/glowshroom,/obj/machinery/atmospherics/pipe/simple/visible/blue,/turf/simulated/floor/asteroid,/area/syndicate_mothership)
"JH" = (/obj/structure/spider/stickyweb,/turf/simulated/mineral,/area/syndicate_mothership)
"JV" = (/obj/structure/flora/jungleplants/glowshroom,/obj/machinery/atmospherics/pipe/simple/visible/blue{dir = 4},/turf/simulated/floor/asteroid,/area/syndicate_mothership)
"Mx" = (/obj/structure/flora/jungleplants/glowshroom,/turf/simulated/floor,/area/syndicate_mothership)
"Nu" = (/turf/simulated/floor,/area/syndicate_mothership)
"Nx" = (/obj/structure/cable/yellow{d1 = 1; d2 = 4; icon_state = "1-4"},/obj/structure/cable/yellow{d1 = 1; d2 = 8; icon_state = "1-8"},/turf/simulated/floor/asteroid,/area/syndicate_mothership)
"NS" = (/mob/living/simple_animal/hostile/asteroid/sand_lurker,/turf/simulated/floor,/area/syndicate_mothership)
"Oe" = (/obj/structure/cable/yellow{d2 = 4; icon_state = "0-4"},/obj/effect/floor_decal/rust,/turf/simulated/floor,/area/syndicate_mothership)
"Oo" = (/obj/machinery/power/port_gen/pacman/super/potato,/obj/structure/cable/yellow{d2 = 2; icon_state = "0-2"},/turf/simulated/floor,/area/syndicate_mothership)
"OA" = (/obj/item/gun/projectile/shotgun/pump/combat,/turf/simulated/floor/asteroid,/area/syndicate_mothership)
"PH" = (/obj/structure/spider/stickyweb,/obj/structure/spider/stickyweb,/turf/simulated/floor/asteroid,/area/syndicate_mothership)
"PK" = (/obj/effect/acid,/turf/simulated/floor,/area/syndicate_mothership)
"Qk" = (/obj/structure/flora/jungleplants/glowshroom,/turf/simulated/floor/asteroid,/area/syndicate_mothership)
"Qo" = (/obj/structure/inflatable/wall,/turf/simulated/floor/asteroid,/area/syndicate_mothership)
"QD" = (/obj/machinery/atmospherics/pipe/simple/visible/blue{dir = 4},/turf/simulated/floor/asteroid,/area/syndicate_mothership)
"QJ" = (/obj/structure/table/steel,/obj/random/tech_supply,/turf/simulated/floor/asteroid,/area/syndicate_mothership)
"QR" = (/obj/effect/floor_decal/rust,/turf/simulated/floor,/area/syndicate_mothership)
"Sw" = (/obj/structure/flora/junglevines/heavy,/turf/simulated/floor,/area/syndicate_mothership)
"SN" = (/mob/living/simple_animal/hostile/giant_spider/hunter/scrawny,/turf/simulated/floor,/area/syndicate_mothership)
"TY" = (/obj/structure/closet/crate/medical,/obj/item/stack/medical/advanced/bruise_pack,/obj/item/stack/medical/advanced/bruise_pack,/obj/item/stack/medical/advanced/bruise_pack,/obj/item/stack/medical/advanced/bruise_pack,/obj/item/stack/medical/advanced/bruise_pack,/obj/item/stack/medical/advanced/bruise_pack,/obj/item/stack/medical/advanced/bruise_pack,/obj/item/stack/medical/advanced/ointment,/obj/item/stack/medical/advanced/ointment,/obj/item/stack/medical/advanced/ointment,/obj/item/stack/medical/advanced/ointment,/obj/item/stack/medical/splint,/obj/item/stack/medical/splint,/turf/simulated/floor/asteroid,/area/syndicate_mothership)
"XB" = (/mob/living/simple_animal/hostile/giant_spider/nurse/ice,/turf/simulated/floor/asteroid,/area/syndicate_mothership)
"XU" = (/obj/item/stack/material/uranium/ten,/obj/item/stack/material/uranium/ten,/obj/item/stack/material/uranium/ten,/obj/item/stack/material/uranium/ten,/obj/item/stack/material/uranium/ten,/obj/item/stack/material/uranium/ten,/turf/simulated/floor/asteroid,/area/syndicate_mothership)
"Yp" = (/turf/unsimulated/wall{icon_state = "rock"},/area/syndicate_mothership)
"Zg" = (/turf/simulated/mineral,/area/syndicate_mothership)
"ZH" = (/obj/item/trash/cans/dr_gibb,/turf/simulated/floor/asteroid,/area/syndicate_mothership)

(1,1,1) = {"
YpYpYpYpYpYpYpYpYpYpYpYpYpYpYpYpYpYpYpYpYpYpYpYpYpYpYpYpYpYp
YpZgvMvMZgejZgdZdZdZZgZgZgZgZgZgZgZgZgZgZgJHdZNudZdZZgZgZgYp
YpvMZgdZvMdZdZejdZNuvMvMZgdZejICejdZZgZgdZdZdZdZdZNuNudZZgYp
YpZgZgdZdZNudZdZNudZdZdZZgZgZgdZdZfqZgQkdZZgZgZgZgdZQkdZZgYp
YpZgdZQkdZdZZgdZdZQkdZZgZgvMvMdZZgvMZgQkZgZgdZdZZgdZdZdZZgYp
YpZgZgZgdZDUdZdZdZZgZgdZdZDUdZdZdZdZZgdZZgdZdZdZZgXBdZZgZgYp
YpEBEBvMNuNuiLQkdZZgdZNuNudZQkABdZQkdZdZvMvMZgdZZgdZdZZgZgYp
YpdZdZdZNuSNdZdZdZZgdZNuNudZdZdZQkHzQDEfdZdZZgdZZgdZdZZgZgYp
YpJVEfNuNudZdZDUdZxrNudZdZZgdZZgdZIhZgIVSwNudZDUZgdZdZdZZgYp
YpdZIVNuNudZQkdZdZdZNudZZgejZgZgdDitZgIVNuNSdZdZvMZgZgZgZgYp
YpnoIVdZdZdZmkdZZgdZPKNudZPHejZgZgZgdZJoNudZNuNudZdZZgZgejYp
YpZgZgdZQkdZNudZZgZgDUdZdZQkdZdZdZdZdZIVdZdZZgdZdZNudZdZdZYp
YpejZgZgdZdZNudZdZdZZgdZdZxrdZdZSwdZNudZZgZgZgdZdZNudZvMdZYp
YpejejejZgdZdZZgZgZgZgZgZgZgNudZxrdZdZZgZgZgZgZgdZMxNSdZZgYp
YpdZrrZgvMdZdZdZxrdZdZiLZgZgdZNSQkdZZgZgXUOodZZgdZNuNuNuZgYp
YprfNuZgZgdZdZNudZQkiLZgZgZgdZNuDUdZZgdZOeNxenbFZgZgdZNudrYp
YpuqNuQksgdZlldZdZdZZgZgZgdZdZDidZdZZgbZwPrGdZQkdZZgdZdZdZYp
YpuqQkdZZHdZdZZgZgZgZgNudZNuQkdZNuZgZgdZdZlYdZrGdZZgdZNudZYp
YpiLNuTYdZZgZgZgZgejdZdZiLQkdZdZNuZgZgbZZgZgZgdZdZZgdZdZNuYp
YpZgZgZgZgZgvMQodZdZNudZdZdZNucEZgdZDUNudZnoZgdZdZZgZgmkZgYp
YpZgZgZgdZQkdZlONuiLQkejdZdZdZZgZgdZdZbZdZnoZgZgdZvMdZdZZgYp
YpZgZgzNdZNuQkQodZDUZgZgZgejZgZgdZxrQRdZbZZgZgZgvMQkdZdZvMYp
YpZgZgdZOAvMZgoqZgZgejZgZgZgdZdZbZQkdZZgZgZgZglslsdZdZdZZgYp
YpejdZdZZgZgZgZgZgZgZgdZdZdZNuNuQRdZZgdZdZZgdZdZDUQkiLNuvMYp
YpdZQkdZvMZgZgZgZgdZdZdZiLdZdZbZNuQRQJZgdZZgvMdZdZQkdZNuvMYp
YpdZNudZvMZgZgZgZgdZMxNudZZgZgZgNuNudZdZdZZgZgdZxrNudZdZZgYp
YpNudZQkdZZgZgZgdZNudZZgZgZgdZZgZgdZNudZdZZgdZdZdZNudZubZgYp
YpZgdZNudZZgZgZgNutJlsZgZgZgdZvMQJdZdZvLdZdZdZQkdZNudZubZgYp
YpZgvMBpZgZgZgdZQkvMvMvMZgdZdZejejbzbzbqNuNudZNudZdZubgxejYp
YpYpYpYpYpYpYpYpYpYpYpYpYpYpYpYpYpYpYpYpYpYpYpYpYpYpYpYpYpYp
"}
