"a" = (/turf/simulated/floor/asteroid,/area/space)
"c" = (/obj/structure/dispenser/oxygen,/obj/effect/floor_decal/industrial/warning{dir = 1},/obj/machinery/access_button{pixel_y = 29},/turf/simulated/floor/tiled/rough,/area/space)
"e" = (/obj/machinery/door/airlock/external{frequency = 1380; icon_state = "door_locked"; id_tag = "radionstation"; locked = 1; name = "Radio station"; req_access = list(13)},/turf/simulated/floor/plating,/area/space)
"f" = (/obj/effect/floor_decal/industrial/warning{dir = 1},/obj/machinery/atmospherics/pipe/simple/hidden/supply{dir = 10},/obj/machinery/atmospherics/pipe/simple/hidden/scrubbers{dir = 6},/turf/simulated/floor/plating,/area/space)
"g" = (/obj/machinery/atmospherics/pipe/simple/hidden{dir = 9},/turf/simulated/floor/tiled/rough,/area/space)
"i" = (/obj/structure/bed/chair/black,/turf/simulated/floor/tiled/rough,/area/space)
"j" = (/obj/machinery/access_button{dir = 1; pixel_y = -28},/turf/simulated/floor/asteroid,/area/space)
"l" = (/obj/structure/window_frame/grille/rglass,/turf/simulated/floor/plating,/area/space)
"m" = (/obj/effect/floor_decal/industrial/warning{dir = 1},/obj/machinery/atmospherics/pipe/simple/hidden/universal,/turf/simulated/floor/tiled/rough,/area/space)
"p" = (/obj/effect/floor_decal/industrial/warning{dir = 9},/obj/machinery/light/small/red{dir = 1},/obj/machinery/atmospherics/pipe/vent{dir = 4},/turf/simulated/floor/plating,/area/space)
"q" = (/obj/machinery/atmospherics/pipe/simple/hidden{dir = 4},/turf/simulated/floor/tiled/rough,/area/space)
"r" = (/obj/item/device/radio/intercom{dir = 1; pixel_y = -30},/turf/simulated/floor/tiled/rough,/area/space)
"s" = (/obj/effect/floor_decal/industrial/warning{dir = 6; icon_state = "warning"},/obj/machinery/atmospherics/unary/vent_scrubber{dir = 8},/turf/simulated/floor/plating,/area/space)
"t" = (/turf/simulated/floor/tiled/rough,/area/space)
"x" = (/obj/structure/sign/poster{pixel_y = 32},/obj/structure/table/rack,/obj/item/clothing/suit/space/void/mining/prepared,/obj/effect/floor_decal/industrial/warning{dir = 1},/turf/simulated/floor/tiled/rough,/area/space)
"z" = (/obj/machinery/light{dir = 1},/obj/machinery/portable_atmospherics/canister/air/airlock,/obj/machinery/atmospherics/portables_connector{dir = 4},/turf/simulated/floor/tiled/rough,/area/space)
"C" = (/obj/effect/floor_decal/industrial/warning,/obj/machinery/atmospherics/pipe/manifold/hidden/scrubbers{dir = 8},/obj/machinery/atmospherics/pipe/manifold/hidden/supply{dir = 4},/turf/simulated/floor/plating,/area/space)
"D" = (/obj/machinery/door/airlock/external{frequency = 1380; icon_state = "door_locked"; id_tag = "radionstation"; locked = 1; name = "Radio station"; req_access = list(13)},/obj/machinery/atmospherics/pipe/simple/hidden/supply,/obj/machinery/atmospherics/pipe/simple/hidden/scrubbers,/turf/simulated/floor/plating,/area/space)
"F" = (/obj/effect/floor_decal/industrial/warning{dir = 5},/obj/machinery/light/small/red{dir = 1},/obj/machinery/access_button{pixel_y = 33},/obj/machinery/atmospherics/unary/vent_scrubber{dir = 8},/turf/simulated/floor/plating,/area/space)
"G" = (/turf/simulated/wall,/area/space)
"I" = (/obj/structure/table/standard,/obj/machinery/chemical_dispenser/bar_soft/full,/obj/machinery/light{dir = 1},/turf/simulated/floor/tiled/rough,/area/space)
"M" = (/obj/effect/floor_decal/industrial/warning{dir = 10; icon_state = "warning"},/obj/machinery/access_button{dir = 1; pixel_y = -28},/obj/machinery/embedded_controller/radio/airlock/access_controller{dir = 4; pixel_x = -32},/obj/machinery/atmospherics/pipe/vent{dir = 4},/turf/simulated/floor/plating,/area/space)
"O" = (/obj/structure/table/standard,/obj/item/device/radio/phone,/turf/simulated/floor/tiled/rough,/area/space)
"P" = (/obj/structure/table/standard,/obj/item/reagent_containers/vessel/glass/square,/obj/machinery/power/apc{name = "south bump"; pixel_y = -24},/turf/simulated/floor/tiled/rough,/area/space)
"Q" = (/obj/structure/table/standard,/turf/simulated/floor/tiled/rough,/area/space)
"S" = (/obj/structure/table/standard,/obj/item/device/radio,/obj/item/device/radio/headset/tactical,/turf/simulated/floor/tiled/rough,/area/space)
"Y" = (/obj/structure/closet/crate/handmade,/obj/item/reagent_containers/food/liquidfood,/obj/item/reagent_containers/food/liquidfood,/obj/item/reagent_containers/food/liquidfood,/obj/item/reagent_containers/food/liquidfood,/obj/item/reagent_containers/food/liquidfood,/obj/item/reagent_containers/food/liquidfood,/obj/item/reagent_containers/food/liquidfood,/obj/item/reagent_containers/food/liquidfood,/turf/simulated/floor/tiled/rough,/area/space)

(1,1,1) = {"
aaajaaaaaa
aaGGeGGaaa
aaGpfFGaaa
aaGMCsGaaa
aaGGDGGaaa
aGGxmcGGaa
alzqgtIlaa
alYritPlaa
aGGQOSGGaa
aaGlllGaaa
"}
