"a" = (/turf/simulated/floor/asteroid,/area/space)
"b" = (/obj/machinery/atmospherics/unary/vent_scrubber{dir = 1},/obj/effect/floor_decal/industrial/warning{dir = 10},/turf/simulated/floor/plating,/area/space)
"c" = (/obj/machinery/access_button{dir = 4; pixel_x = -32},/turf/simulated/floor/asteroid,/area/space)
"d" = (/obj/structure/window_frame/grille/rglass,/turf/simulated/floor/plating,/area/space)
"e" = (/obj/structure/table/rack,/obj/structure/sign/poster{pixel_x = 32},/turf/simulated/floor/tiled/rough,/area/space)
"g" = (/obj/machinery/door/airlock/external{frequency = 1380; icon_state = "door_locked"; id_tag = "radionstation"; locked = 1; name = "Radio station"; req_access = list(13)},/obj/machinery/atmospherics/pipe/simple/hidden/supply{dir = 4},/obj/machinery/atmospherics/pipe/simple/hidden/scrubbers{dir = 4},/turf/simulated/floor/plating,/area/space)
"i" = (/turf/simulated/floor/tiled/rough,/area/space)
"m" = (/obj/structure/table/standard,/obj/machinery/power/apc{dir = 8; name = "west bump"; pixel_x = -24},/turf/simulated/floor/tiled/rough,/area/space)
"n" = (/obj/machinery/atmospherics/pipe/vent,/obj/machinery/light/small/red{dir = 4},/obj/effect/floor_decal/industrial/warning{dir = 5},/turf/simulated/floor/plating,/area/space)
"r" = (/obj/machinery/atmospherics/pipe/simple/hidden/scrubbers{dir = 10},/obj/machinery/atmospherics/pipe/simple/hidden/supply{dir = 9},/obj/effect/floor_decal/industrial/warning{dir = 4},/turf/simulated/floor/plating,/area/space)
"u" = (/obj/machinery/portable_atmospherics/canister/air/airlock,/obj/machinery/atmospherics/portables_connector,/obj/machinery/light{dir = 4},/turf/simulated/floor/tiled/rough,/area/space)
"v" = (/obj/machinery/atmospherics/pipe/vent,/obj/effect/floor_decal/industrial/warning{dir = 9},/obj/machinery/embedded_controller/radio/airlock/access_controller{pixel_y = 32},/obj/machinery/access_button{dir = 4; pixel_x = -32},/turf/simulated/floor/plating,/area/space)
"x" = (/obj/structure/window_frame,/obj/structure/grille/broken,/obj/item/arrow/rod,/obj/item/arrow/rod,/obj/item/material/shard,/turf/simulated/floor/plating,/area/space)
"y" = (/obj/structure/table/standard,/turf/simulated/floor/tiled/rough,/area/space)
"z" = (/obj/structure/closet/crate/handmade,/turf/simulated/floor/tiled/rough,/area/space)
"C" = (/obj/machinery/atmospherics/pipe/manifold/hidden/supply,/obj/machinery/atmospherics/pipe/manifold/hidden/scrubbers{dir = 1},/obj/effect/floor_decal/industrial/warning{dir = 8},/turf/simulated/floor/plating,/area/space)
"D" = (/obj/structure/dispenser/oxygen,/obj/machinery/access_button{dir = 4; pixel_x = 32},/turf/simulated/floor/tiled/rough,/area/space)
"E" = (/obj/machinery/door/airlock/external{frequency = 1380; icon_state = "door_locked"; id_tag = "radionstation"; locked = 1; name = "Radio station"; req_access = list(13)},/turf/simulated/floor/plating,/area/space)
"F" = (/turf/simulated/wall,/area/space)
"H" = (/obj/effect/decal/cleanable/blood,/turf/simulated/floor/tiled/rough,/area/space)
"J" = (/obj/structure/table/standard,/obj/item/device/radio/phone,/turf/simulated/floor/tiled/rough,/area/space)
"O" = (/obj/item/foldchair,/mob/living/simple_animal/hostile/asteroid/hoverhead,/turf/simulated/floor/tiled/rough,/area/space)
"Q" = (/obj/machinery/atmospherics/pipe/simple/hidden/universal{dir = 4},/turf/simulated/floor/tiled/rough,/area/space)
"S" = (/obj/structure/window_frame,/obj/structure/grille,/obj/item/material/shard,/turf/simulated/floor/plating,/area/space)
"T" = (/obj/machinery/atmospherics/pipe/simple/hidden,/turf/simulated/floor/tiled/rough,/area/space)
"U" = (/obj/machinery/atmospherics/pipe/simple/hidden{dir = 5},/turf/simulated/floor/tiled/rough,/area/space)
"V" = (/obj/structure/table/standard,/obj/machinery/light{dir = 4},/turf/simulated/floor/tiled/rough,/area/space)
"W" = (/obj/machinery/atmospherics/unary/vent_scrubber{dir = 1},/obj/machinery/light/small/red{dir = 4},/obj/effect/floor_decal/industrial/warning{dir = 6},/obj/machinery/access_button{dir = 8; pixel_x = 32},/turf/simulated/floor/plating,/area/space)
"X" = (/obj/item/device/radio/intercom{dir = 4; pixel_x = -27},/obj/effect/decal/cleanable/blood,/turf/simulated/floor/tiled/rough,/area/space)
"Y" = (/obj/structure/girder,/turf/simulated/floor/plating,/area/space)

(1,1,1) = {"
aaaaaaaaaa
aFddFaaaaa
FFzuYFFFFa
dyXTeFvnFc
SJOUQgCrEa
dyiHDYbWFa
FFmVFFFFFa
aFSxFaaaaa
aaaaaaaaaa
aaaaaaaaaa
"}
