"a" = (/turf/simulated/floor/asteroid,/area/space)
"d" = (/obj/effect/floor_decal/industrial/warning{dir = 1},/obj/machinery/atmospherics/pipe/simple/hidden/universal,/obj/effect/floor_decal/rust,/turf/simulated/floor/tiled/rough,/area/space)
"e" = (/obj/structure/sign/poster{pixel_y = 32},/obj/structure/table/rack,/obj/effect/floor_decal/industrial/warning{dir = 1},/turf/simulated/floor/tiled/rough,/area/space)
"h" = (/obj/effect/floor_decal/industrial/warning{dir = 6; icon_state = "warning"},/obj/machinery/atmospherics/unary/vent_scrubber{dir = 8},/obj/effect/floor_decal/rust,/turf/simulated/floor/plating,/area/space)
"i" = (/obj/effect/floor_decal/rust,/turf/simulated/floor/tiled/rough,/area/space)
"j" = (/obj/machinery/light{dir = 1},/obj/machinery/portable_atmospherics/canister/air/airlock,/obj/machinery/atmospherics/portables_connector{dir = 4},/turf/simulated/floor/tiled/rough,/area/space)
"n" = (/obj/structure/girder,/turf/simulated/floor/plating,/area/space)
"o" = (/obj/structure/table/standard,/obj/item/trash/liquidfood,/turf/simulated/floor/tiled/rough,/area/space)
"q" = (/obj/effect/floor_decal/industrial/warning,/obj/machinery/atmospherics/pipe/manifold/hidden/scrubbers{dir = 8},/obj/machinery/atmospherics/pipe/manifold/hidden/supply{dir = 4},/obj/effect/floor_decal/rust,/turf/simulated/floor/plating,/area/space)
"t" = (/obj/machinery/atmospherics/pipe/simple/hidden{dir = 9},/obj/effect/floor_decal/rust,/turf/simulated/floor/plating,/area/space)
"u" = (/obj/machinery/door/airlock/external{frequency = 1380; icon_state = "door_locked"; id_tag = "radionstation"; locked = 1; name = "Radio station"; req_access = list(13)},/turf/simulated/floor/plating,/area/space)
"v" = (/obj/item/device/radio/intercom{dir = 1; pixel_y = -30},/obj/effect/floor_decal/rust,/obj/effect/mob_spawn/corpse/human/damaged,/obj/item/device/radio,/obj/effect/decal/cleanable/blood,/turf/simulated/floor/tiled/rough,/area/space)
"x" = (/obj/structure/closet/crate/handmade,/obj/item/reagent_containers/food/liquidfood,/obj/item/reagent_containers/food/liquidfood,/obj/item/reagent_containers/food/liquidfood,/obj/item/reagent_containers/food/liquidfood,/turf/simulated/floor/tiled/rough,/area/space)
"y" = (/obj/structure/table/standard,/mob/living/simple_animal/hostile/asteroid/p_anomaly,/turf/simulated/floor/tiled/rough,/area/space)
"A" = (/turf/simulated/wall,/area/space)
"C" = (/obj/machinery/door/airlock/external{frequency = 1380; icon_state = "door_locked"; id_tag = "radionstation"; locked = 1; name = "Radio station"; req_access = list(13)},/obj/machinery/atmospherics/pipe/simple/hidden/supply,/obj/machinery/atmospherics/pipe/simple/hidden/scrubbers,/turf/simulated/floor/plating,/area/space)
"D" = (/obj/effect/floor_decal/industrial/warning{dir = 9},/obj/machinery/light/small/red{dir = 1},/obj/machinery/atmospherics/pipe/vent{dir = 4},/obj/effect/floor_decal/rust,/turf/simulated/floor/plating,/area/space)
"G" = (/obj/machinery/atmospherics/pipe/simple/hidden{dir = 4},/mob/living/simple_animal/hostile/asteroid/p_anomaly,/obj/item/device/radio/headset/tactical,/turf/simulated/floor/tiled/rough,/area/space)
"H" = (/obj/structure/table/standard,/obj/machinery/power/apc{name = "south bump"; pixel_y = -24},/turf/simulated/floor/tiled/rough,/area/space)
"J" = (/obj/structure/table/standard,/obj/machinery/light{dir = 1},/turf/simulated/floor/tiled/rough,/area/space)
"K" = (/obj/effect/floor_decal/rust,/obj/effect/decal/cleanable/blood,/turf/simulated/floor/tiled/rough,/area/space)
"M" = (/obj/effect/floor_decal/industrial/warning{dir = 1},/obj/machinery/atmospherics/pipe/simple/hidden/supply{dir = 10},/obj/machinery/atmospherics/pipe/simple/hidden/scrubbers{dir = 6},/obj/effect/floor_decal/rust,/turf/simulated/floor/plating,/area/space)
"N" = (/obj/structure/dispenser/oxygen,/obj/effect/floor_decal/industrial/warning{dir = 1},/obj/machinery/access_button{pixel_y = 29},/turf/simulated/floor/tiled/rough,/area/space)
"O" = (/obj/effect/floor_decal/industrial/warning{dir = 5},/obj/machinery/light/small/red{dir = 1},/obj/machinery/access_button{pixel_y = 33},/obj/machinery/atmospherics/unary/vent_scrubber{dir = 8},/obj/effect/floor_decal/rust,/turf/simulated/floor/plating,/area/space)
"Q" = (/obj/effect/floor_decal/industrial/warning{dir = 10; icon_state = "warning"},/obj/machinery/access_button{dir = 1; pixel_y = -28},/obj/machinery/embedded_controller/radio/airlock/access_controller{dir = 4; pixel_x = -32},/obj/machinery/atmospherics/pipe/vent{dir = 4},/obj/effect/floor_decal/rust,/turf/simulated/floor/plating,/area/space)
"S" = (/obj/structure/window_frame/grille/rglass,/turf/simulated/floor/plating,/area/space)
"T" = (/obj/structure/window_frame,/obj/item/material/shard,/obj/structure/grille/broken,/obj/item/arrow/rod,/obj/item/arrow/rod,/turf/simulated/floor/plating,/area/space)
"V" = (/obj/structure/table/standard,/obj/item/device/radio/phone,/obj/effect/floor_decal/rust,/turf/simulated/floor/tiled/rough,/area/space)
"W" = (/obj/machinery/access_button{dir = 1; pixel_y = -28},/turf/simulated/floor/asteroid,/area/space)
"X" = (/obj/structure/bed/chair/black,/mob/living/simple_animal/hostile/asteroid/p_anomaly,/turf/simulated/floor/tiled/rough,/area/space)
"Z" = (/obj/structure/window_frame,/obj/structure/grille,/obj/item/material/shard,/turf/simulated/floor/plating,/area/space)

(1,1,1) = {"
aaaWaaaaaa
aaAAuAAaaa
aaADMOAaaa
aaAQqhAaaa
aaAACnAaaa
aAAedNAAaa
aSjGtKJTaa
aSxvXiHSaa
aAAyVoAAaa
aaASZSAaaa
"}
