"a" = (/turf/simulated/floor/asteroid,/area/space)
"e" = (/obj/structure/table/standard,/obj/item/device/radio,/obj/item/device/radio/headset/tactical,/turf/simulated/floor/tiled/rough,/area/space)
"f" = (/obj/structure/table/standard,/obj/item/device/radio/phone,/turf/simulated/floor/tiled/rough,/area/space)
"g" = (/obj/machinery/atmospherics/pipe/vent,/obj/machinery/light/small/red{dir = 4},/obj/effect/floor_decal/industrial/warning{dir = 5},/turf/simulated/floor/plating,/area/space)
"i" = (/turf/simulated/floor/tiled/rough,/area/space)
"m" = (/obj/machinery/atmospherics/pipe/simple/hidden/scrubbers{dir = 10},/obj/machinery/atmospherics/pipe/simple/hidden/supply{dir = 9},/obj/effect/floor_decal/industrial/warning{dir = 4},/turf/simulated/floor/plating,/area/space)
"n" = (/obj/machinery/door/airlock/external{frequency = 1380; icon_state = "door_locked"; id_tag = "radionstation"; locked = 1; name = "Radio station"; req_access = list(13)},/turf/simulated/floor/plating,/area/space)
"p" = (/obj/machinery/atmospherics/pipe/simple/hidden/universal{dir = 4},/turf/simulated/floor/tiled/rough,/area/space)
"r" = (/obj/machinery/portable_atmospherics/canister/air/airlock,/obj/machinery/atmospherics/portables_connector,/obj/machinery/light{dir = 4},/turf/simulated/floor/tiled/rough,/area/space)
"t" = (/obj/machinery/atmospherics/unary/vent_scrubber{dir = 1},/obj/machinery/light/small/red{dir = 4},/obj/effect/floor_decal/industrial/warning{dir = 6},/obj/machinery/access_button{dir = 8; pixel_x = 32},/turf/simulated/floor/plating,/area/space)
"u" = (/obj/structure/table/standard,/obj/machinery/light{dir = 4},/turf/simulated/floor/tiled/rough,/area/space)
"x" = (/obj/structure/bed/chair/black{dir = 8},/turf/simulated/floor/tiled/rough,/area/space)
"z" = (/obj/machinery/door/airlock/external{frequency = 1380; icon_state = "door_locked"; id_tag = "radionstation"; locked = 1; name = "Radio station"; req_access = list(13)},/obj/machinery/atmospherics/pipe/simple/hidden/supply{dir = 4},/obj/machinery/atmospherics/pipe/simple/hidden/scrubbers{dir = 4},/turf/simulated/floor/plating,/area/space)
"C" = (/turf/simulated/wall,/area/space)
"G" = (/obj/item/device/radio/intercom{dir = 4; pixel_x = -27},/turf/simulated/floor/tiled/rough,/area/space)
"H" = (/obj/machinery/atmospherics/pipe/simple/hidden,/turf/simulated/floor/tiled/rough,/area/space)
"I" = (/obj/machinery/atmospherics/pipe/manifold/hidden/supply,/obj/machinery/atmospherics/pipe/manifold/hidden/scrubbers{dir = 1},/obj/effect/floor_decal/industrial/warning{dir = 8},/turf/simulated/floor/plating,/area/space)
"J" = (/obj/structure/window_frame/grille/rglass,/turf/simulated/floor/plating,/area/space)
"K" = (/obj/structure/table/rack,/obj/item/clothing/suit/space/void/mining/prepared,/obj/structure/sign/poster{pixel_x = 32},/turf/simulated/floor/tiled/rough,/area/space)
"L" = (/obj/machinery/atmospherics/unary/vent_scrubber{dir = 1},/obj/effect/floor_decal/industrial/warning{dir = 10},/turf/simulated/floor/plating,/area/space)
"Q" = (/obj/structure/closet/crate/handmade,/obj/item/reagent_containers/food/liquidfood,/obj/item/reagent_containers/food/liquidfood,/obj/item/reagent_containers/food/liquidfood,/obj/item/reagent_containers/food/liquidfood,/obj/item/reagent_containers/food/liquidfood,/obj/item/reagent_containers/food/liquidfood,/obj/item/reagent_containers/food/liquidfood,/obj/item/reagent_containers/food/liquidfood,/turf/simulated/floor/tiled/rough,/area/space)
"S" = (/obj/structure/dispenser/oxygen,/obj/machinery/access_button{dir = 4; pixel_x = 32},/turf/simulated/floor/tiled/rough,/area/space)
"T" = (/obj/machinery/access_button{dir = 4; pixel_x = -32},/turf/simulated/floor/asteroid,/area/space)
"U" = (/obj/structure/table/standard,/obj/machinery/power/apc{dir = 8; name = "west bump"; pixel_x = -24},/turf/simulated/floor/tiled/rough,/area/space)
"V" = (/obj/machinery/atmospherics/pipe/vent,/obj/effect/floor_decal/industrial/warning{dir = 9},/obj/machinery/embedded_controller/radio/airlock/access_controller{pixel_y = 32},/obj/machinery/access_button{dir = 4; pixel_x = -32},/turf/simulated/floor/plating,/area/space)
"X" = (/obj/machinery/atmospherics/pipe/simple/hidden{dir = 5},/turf/simulated/floor/tiled/rough,/area/space)
"Z" = (/obj/structure/table/standard,/turf/simulated/floor/tiled/rough,/area/space)

(1,1,1) = {"
aaaaaaaaaa
aCJJCaaaaa
CCQrCCCCCa
JZGHKCVgCT
JfxXpzImna
JeiiSCLtCa
CCUuCCCCCa
aCJJCaaaaa
aaaaaaaaaa
aaaaaaaaaa
"}
