"a" = (/obj/structure/snow,/turf/unsimulated/floor/frozenground,/area/polarplanet/street)
"b" = (/obj/structure/snow,/obj/structure/flora/grass/green,/turf/unsimulated/floor/frozenground,/area/polarplanet/street)
"c" = (/obj/structure/snow,/obj/structure/snow,/turf/unsimulated/floor/frozenground,/area/polarplanet/street)
"e" = (/obj/structure/snow,/obj/structure/flora/grass/brown,/turf/unsimulated/floor/frozenground,/area/polarplanet/street)
"f" = (/obj/structure/snow,/obj/structure/flora/grass/green,/turf/simulated/floor/natural/frozenground/cave,/area/polarplanet/street)
"g" = (/mob/living/simple_animal/hostile/asteroid/goliath,/turf/simulated/floor/natural/frozenground/cave,/area/polarplanet/street)
"h" = (/mob/living/simple_animal/hostile/asteroid/goliath/alpha,/turf/simulated/floor/natural/frozenground/cave,/area/polarplanet/street)
"m" = (/obj/structure/rock,/turf/simulated/floor/natural/frozenground/cave,/area/polarplanet/street)
"t" = (/turf/simulated/floor/natural/frozenground/cave,/area/polarplanet/street)
"w" = (/obj/item/asteroid/beholder_eye,/turf/simulated/floor/natural/frozenground/cave,/area/polarplanet/street)
"B" = (/turf/unsimulated/floor/frozenground,/area/polarplanet/street)
"E" = (/obj/structure/flora/jungleplants/glowshroom,/turf/simulated/floor/natural/frozenground/cave,/area/polarplanet/street)
"M" = (/turf/simulated/mineral,/area/polarplanet/street)
"Q" = (/obj/structure/snow,/turf/simulated/floor/natural/frozenground/cave,/area/polarplanet/street)

(1,1,1) = {"
BBBBBBBBBBBBBBBBBBBBBBBBBBBBBBBBBBBBBBBBBBBBBBBBBB
BBBBBBBBBBBBBBBBBBBBBBBBBBBBBBBBBBBBBBBBBBBBBBBBBB
BBBBBBBBBBBBBBBBBBBBBBBBBBBBBBBBBBBBBBBBBBBBBBBBBB
BBBBBBBBBBBBBBBBBBBBBBBBBBBBBBBBBBBBBBBBBBBBBBBBBB
BBBBBBBBBBBBBBBBBBBBBBBBBBBBBBBBBBBBBBBBBBBBBBBBBB
BBBBBBBBBBBBBBBBBBBBBBBBBBBBBBBBBBBBBBBBBBBBBBBBBB
BBBBBBBBBBBBBBBBBBBBBBBBBBBBBBBBBBBBBBBBBBBBBBBBBB
BBBBBBBBBBBBBBBBBBBBMMMMaaaaBBBBBBBBBBBBBBBBBBBBBB
BBBBBBBBBBBBBBBBBBBMMMMMMaaaaaBBBBBBBBBBBBBBBBBBBB
BBBBBBBBBBBBBBBBaaMMMMMMMMMMaaaaBBBBBBBBBBBBBBBBBB
BBBBBBBBBBBBBBaaMMMMMMMMMMMMMMaaaBBBBBBBBBBBBBBBBB
BBBBBBBBBBBBacMMMMMMMMMMMMMMMMMMaaaBBBBBBBBBBBBBBB
BBBBBBBBBBBaMMMMMMMMMMMMMMMMMMMMMaaaaBBBBBBBBBBBBB
BBBBBBBBBabMMMMMMMMMMMMMMMMMMMMMMaaaaaBBBBBBBBBBBB
BBBBBBBBBMMMMMMMMMMMMMMMMMMMMMMMMMMaaaaBBBBBBBBBBB
BBBBBBBBaMMMMMtttMMMMMMMMMMMMMMMMMMMaaaBBBBBBBBBBB
BBBBBBBBMMMMMMttttMMMMMmMttMMMMMMMMMMaaaaBBBBBBBBB
BBBBBBMMMMMMMMMtttMMMmmtttttttMMMMMMMMMaaaaBBBBBBB
BBBBBMMMMMMMMMMMMttMttmMttttttmMMMMMMMMMMaaaBBBBBB
BBBBBMMtttMMMMMMMttttMMMMMttttttttMMMMMMMaaaaBBBBB
BBBBBMQttttMMMMMMEtttMMMMMMMMtttEttMMMMMMMaaaaBBBB
BBBBBfQMtttMMMMMmEEtMMMMMMMMMMMMttttMMMMMMMaaaaBBB
BBBBBQMMmtttMMMMtEtMMMMMMMMMMMMMmtttMMMMMMMaaaBBBB
BBBBBtMMmMttttttEtMMMMMMMMMMMMMMMtEtMMMMMMMMaaBBBB
BBBBBBMMMMMtttttttMMMMMmtMMMMMMMMttMMMMMMMMMccBBBB
BBBBBBMMMMMMtttgtMMMMMmthttmMMMMMttMMMMMMMMMaaBBBB
BBBBBBBMMMMMMtttttMMMMtttwttMMMMttttMMMMMMMaaaBBBB
BBBBBBBBaMMMMMttttMMMMttttEMMMMMttttMMMMMMaaaBBBBB
BBBBBBBBaMMMMMMtttMMMMtMMEmMMMMtttMttMMMMMaaaBBBBB
BBBBBBBBaeMMMMMtttMMMMtMMMmMMtttEEMMtttMMeaaaaBBBB
BBBBBBBabaeMMMMMttMMMMttMMMMtttEmMMMMMQbMaaaaaBBBB
BBBBBBaaaaeMMMMMttMMMMMtttMtgttMMMMMMMMaeaaaaaBBBB
BBBBBBBaabMMMMMMttMMMMMMMtttttMMMMMMMMMMaaaaaaaBBB
BBBBBBBaabMMMMMmEtMMMMMMMEEtMMMMMMMMMMMMbaaaaaBBBB
BBBBBBBBaMMMMMMEttMMMMMMMmMMMMMMMMMMMMMMMaaaaaBBBB
BBBBBBBBaMMMMMtttMMMMMMMMMMMMMMMMmtMMMMMMaaaaBBBBB
BBBBBBBBMMMMMMttMMMMMMttMMMMMMtttttttQMMMaaaaBBBBB
BBBBBBBBMMMMMttMMMMMmEtttMMMMtttMMMMMQQQaaaaBBBBBB
BBBBBBBBMMMMttMMMMMMttEtEtMMtttMMMMMMMMbaaaBBBBBBB
BBBBBBBBMMMmttMMMMtttttEEttttMMMMMMMMMMMeaaBBBBBBB
BBBBBBBBtMQttttMMtttMMMMMMMMMMMMMMMMMMMMaaaBBBBBBB
BBBBBBBBBQQtttttttMMMMMMMMMMMMMMMMMMMMMaaBBBBBBBBB
BBBBBBBBBbMMMMMMMMMMMMMMMMMMMMMMMMMBBBBBBBBBBBBBBB
BBBBBBBBBBMMMMMMMMMMMMMMMMMMMeaBBBBBBBBBBBBBBBBBBB
BBBBBBBBBBBBMMMMMMMMMMMMMbaaaaBBBBBBBBBBBBBBBBBBBB
BBBBBBBBBBBBBMMMMMMMMMMebBBBBBBBBBBBBBBBBBBBBBBBBB
BBBBBBBBBBBBBBBBBBBBBBBBBBBBBBBBBBBBBBBBBBBBBBBBBB
BBBBBBBBBBBBBBBBBBBBBBBBBBBBBBBBBBBBBBBBBBBBBBBBBB
BBBBBBBBBBBBBBBBBBBBBBBBBBBBBBBBBBBBBBBBBBBBBBBBBB
BBBBBBBBBBBBBBBBBBBBBBBBBBBBBBBBBBBBBBBBBBBBBBBBBB
"}
