"ab" = (/obj/structure/table/steel,/obj/item/clothing/head/welding,/turf/simulated/floor/plating,/area/polarplanet/street)
"ay" = (/obj/structure/table/rack,/turf/unsimulated/floor/frozenground,/area/polarplanet/street)
"aI" = (/obj/structure/sign/warning/docking_area,/turf/simulated/wall/r_wall,/area/polarplanet/street)
"bh" = (/obj/structure/shuttle/engine/propulsion,/obj/structure/table/steel,/turf/simulated/floor/plating,/area/polarplanet/street)
"bG" = (/turf/unsimulated/floor/frozenground,/area/polarplanet/street)
"cb" = (/obj/item/stack/rods/ten,/obj/item/stack/rods/ten,/turf/simulated/floor/plating,/area/polarplanet/street)
"cz" = (/obj/machinery/pipedispenser/disposal,/turf/simulated/floor/plating,/area/polarplanet/street)
"du" = (/obj/structure/table/steel,/obj/item/weldingtool/largetank,/turf/simulated/floor/plating,/area/polarplanet/street)
"gD" = (/obj/item/book/wiki/atmospipes,/turf/simulated/floor/plating,/area/polarplanet/street)
"hh" = (/obj/item/wrench/plain,/turf/simulated/floor/plating,/area/polarplanet/street)
"ix" = (/obj/item/pipe{dir = 6},/turf/simulated/floor/plating,/area/polarplanet/street)
"kM" = (/obj/structure/door_assembly/door_assembly_min,/turf/simulated/floor/plating,/area/polarplanet/street)
"me" = (/obj/structure/table/steel,/obj/item/clothing/glasses/hud/standard/meson,/turf/unsimulated/floor/frozenground,/area/polarplanet/street)
"mw" = (/obj/machinery/floodlight,/turf/unsimulated/floor/frozenground,/area/polarplanet/street)
"nd" = (/obj/machinery/light{dir = 4},/turf/unsimulated/floor/frozenground,/area/polarplanet/street)
"nk" = (/turf/simulated/floor/shuttle/yellow,/area/polarplanet/street)
"oa" = (/obj/structure/table/steel,/obj/item/clothing/glasses/hud/standard/meson/active,/turf/unsimulated/floor/frozenground,/area/polarplanet/street)
"oA" = (/obj/structure/table/steel,/turf/unsimulated/floor/frozenground,/area/polarplanet/street)
"pm" = (/obj/structure/window/shuttle,/turf/simulated/floor/plating,/area/polarplanet/street)
"pz" = (/obj/effect/decal/cleanable/blood/oil,/turf/simulated/floor/natural/frozenground/cave{icon_state = "wground2"; tag = "icon-wground2"},/area/polarplanet/street)
"rQ" = (/obj/effect/decal/cleanable/blood/oil,/turf/unsimulated/floor/frozenground,/area/polarplanet/street)
"ss" = (/obj/machinery/constructable_frame,/turf/simulated/floor/plating,/area/polarplanet/street)
"sP" = (/obj/structure/window/reinforced{dir = 4},/turf/simulated/floor/natural/frozenground/cave{icon_state = "wground2"; tag = "icon-wground2"},/area/polarplanet/street)
"th" = (/obj/item/pipe,/obj/item/pipe,/obj/item/pipe,/obj/item/pipe,/obj/item/pipe,/obj/item/pipe,/turf/simulated/floor/plating,/area/polarplanet/street)
"tm" = (/obj/structure/table/rack,/obj/item/stack/cable_coil,/obj/item/stack/cable_coil,/turf/unsimulated/floor/frozenground,/area/polarplanet/street)
"tP" = (/obj/structure/table/steel,/obj/item/screwdriver,/turf/unsimulated/floor/frozenground,/area/polarplanet/street)
"ux" = (/obj/structure/table/rack,/obj/item/stack/material/steel/fifty,/obj/item/stack/material/steel/fifty,/turf/unsimulated/floor/frozenground,/area/polarplanet/street)
"vO" = (/obj/structure/shuttle/engine/heater,/obj/structure/table/steel,/turf/simulated/floor/plating,/area/polarplanet/street)
"vV" = (/obj/effect/decal/cleanable/blood/oil,/turf/simulated/floor/plating,/area/polarplanet/street)
"wm" = (/obj/structure/table/rack,/obj/item/stack/material/steel/fifty,/turf/unsimulated/floor/frozenground,/area/polarplanet/street)
"wt" = (/obj/structure/shuttle/engine/heater{dir = 8},/obj/structure/window/reinforced{dir = 4},/turf/simulated/floor/natural/frozenground/cave{icon_state = "wground2"; tag = "icon-wground2"},/area/polarplanet/street)
"wD" = (/obj/machinery/vending_frame,/turf/simulated/floor/plating,/area/polarplanet/street)
"wT" = (/obj/structure/table/rack,/obj/item/stack/material/plastic/ten,/obj/item/stack/material/plastic/ten,/turf/unsimulated/floor/frozenground,/area/polarplanet/street)
"xA" = (/obj/structure/shuttle/engine/propulsion{dir = 8},/turf/simulated/floor/natural/frozenground/cave{icon_state = "wground2"; tag = "icon-wground2"},/area/polarplanet/street)
"xG" = (/obj/machinery/floodlight,/turf/simulated/floor/plating,/area/polarplanet/street)
"xM" = (/obj/item/pipe{dir = 5},/obj/item/pipe{dir = 5},/obj/item/pipe{dir = 6},/turf/simulated/floor/plating,/area/polarplanet/street)
"yA" = (/obj/structure/table/steel,/turf/simulated/floor/plating,/area/polarplanet/street)
"yC" = (/obj/item/pipe{dir = 5},/turf/simulated/floor/plating,/area/polarplanet/street)
"yP" = (/turf/simulated/shuttle/wall/corner/blockwhite/ne,/area/polarplanet/street)
"zJ" = (/obj/structure/reagent_dispensers/fueltank,/turf/unsimulated/floor/frozenground,/area/polarplanet/street)
"zR" = (/obj/item/stack/gassembly,/turf/simulated/floor/plating,/area/polarplanet/street)
"AP" = (/obj/item/frame/light,/turf/simulated/floor/plating,/area/polarplanet/street)
"AZ" = (/obj/structure/table/rack,/obj/item/storage/toolbox/mechanical,/turf/unsimulated/floor/frozenground,/area/polarplanet/street)
"CJ" = (/obj/mecha/working/ripley,/obj/machinery/mech_recharger,/obj/effect/floor_decal/industrial/outline/yellow,/turf/simulated/floor/plating,/area/polarplanet/street)
"Dk" = (/obj/item/device/flashlight/flare{on = 1},/turf/simulated/floor/natural/frozenground/cave{icon_state = "wground2"; tag = "icon-wground2"},/area/polarplanet/street)
"DM" = (/obj/structure/table/steel,/obj/item/rig_module/vision/meson,/obj/item/rig_module/vision/meson,/turf/unsimulated/floor/frozenground,/area/polarplanet/street)
"Ed" = (/obj/structure/bed/chair/shuttle/blue{dir = 8},/turf/simulated/floor/shuttle/yellow,/area/polarplanet/street)
"Em" = (/obj/structure/table/rack,/obj/item/backwear/reagent/welding,/turf/unsimulated/floor/frozenground,/area/polarplanet/street)
"FM" = (/obj/structure/grille,/turf/unsimulated/floor/frozenground,/area/polarplanet/street)
"GP" = (/obj/item/stack/material/steel/ten,/turf/simulated/floor/plating,/area/polarplanet/street)
"HJ" = (/obj/machinery/light{dir = 8},/turf/unsimulated/floor/frozenground,/area/polarplanet/street)
"Js" = (/turf/simulated/shuttle/wall/corner/blockwhite/se,/area/polarplanet/street)
"Jw" = (/obj/structure/table/steel,/obj/item/stack/material/plasteel/ten,/turf/simulated/floor/plating,/area/polarplanet/street)
"JI" = (/obj/item/stack/material/plasteel/ten,/obj/item/stack/material/steel/ten,/turf/unsimulated/floor/frozenground,/area/polarplanet/street)
"Kh" = (/obj/item/stack/rods/ten,/turf/simulated/floor/plating,/area/polarplanet/street)
"Kk" = (/obj/machinery/light,/turf/unsimulated/floor/frozenground,/area/polarplanet/street)
"Lu" = (/obj/machinery/porta_turret_construct{anchored = 1},/turf/unsimulated/floor/frozenground,/area/polarplanet/street)
"Mb" = (/obj/machinery/light{dir = 1},/turf/unsimulated/floor/frozenground,/area/polarplanet/street)
"Om" = (/turf/simulated/shuttle/wall,/area/polarplanet/street)
"Pa" = (/obj/item/stack/cable_coil,/turf/simulated/floor/plating,/area/polarplanet/street)
"Tr" = (/mob/living/silicon/robot/drone/construction{bruteloss = 51; dir = 4},/turf/simulated/floor/plating,/area/polarplanet/street)
"UO" = (/obj/structure/table/steel,/obj/item/clothing/glasses/hud/standard/meson,/obj/item/clothing/glasses/hud/standard/meson,/turf/unsimulated/floor/frozenground,/area/polarplanet/street)
"Va" = (/obj/machinery/door/airlock/external/snow{name = "Arrival Airlock"},/turf/simulated/floor/shuttle/yellow,/area/polarplanet/street)
"Vi" = (/obj/item/clothing/head/welding,/obj/item/weldingtool/largetank,/turf/simulated/floor/plating,/area/polarplanet/street)
"Vp" = (/obj/item/stack/gassembly,/turf/unsimulated/floor/frozenground,/area/polarplanet/street)
"VW" = (/obj/structure/table/rack,/obj/item/stack/material/steel/ten,/turf/unsimulated/floor/frozenground,/area/polarplanet/street)
"Wk" = (/obj/structure/ore_box,/turf/unsimulated/floor/frozenground,/area/polarplanet/street)
"WT" = (/obj/machinery/mech_recharger,/obj/effect/floor_decal/industrial/outline/yellow,/turf/simulated/floor/plating,/area/polarplanet/street)
"XA" = (/turf/simulated/wall,/area/polarplanet/street)
"XC" = (/obj/structure/table/rack,/obj/item/stack/material/plastic/fifty,/turf/unsimulated/floor/frozenground,/area/polarplanet/street)
"XS" = (/obj/structure/window_frame,/turf/simulated/floor/plating,/area/polarplanet/street)
"Ya" = (/obj/structure/bed/chair/shuttle/blue{dir = 4},/turf/simulated/floor/shuttle/yellow,/area/polarplanet/street)
"YR" = (/obj/item/frame/light,/obj/item/frame/light,/turf/simulated/floor/plating,/area/polarplanet/street)
"YX" = (/obj/structure/table/steel,/obj/item/clothing/head/welding,/obj/item/weldingtool/largetank,/turf/simulated/floor/plating,/area/polarplanet/street)
"Zk" = (/turf/simulated/floor/natural/frozenground/cave{icon_state = "wground2"; tag = "icon-wground2"},/area/polarplanet/street)
"Zn" = (/obj/item/stack/cable_coil/cyan,/turf/simulated/floor/plating,/area/polarplanet/street)
"Zz" = (/obj/item/device/pipe_painter,/obj/item/wrench/plain,/turf/simulated/floor/plating,/area/polarplanet/street)
"ZT" = (/turf/simulated/floor/plating,/area/polarplanet/street)

(1,1,1) = {"
bGbGbGbGbGbGbGbGbGbGbGbGbGbGbGbGbGbGbGbGbGbGbGbGbGbGbGbGbGbGbGbGbGbGbGbGbGbGbGbGbGbGbGbGbGbGbGbGbGbGbGbGbGbGbGbGbGbGbGbGbGbGbGbGbGbGbGbGbGbGbGbGbGbGbGbGbGbGbGbGbGbGbGbGbGbGbGbGbGbGbGbGbGbGbGbGbGbGbGbG
bGbGbGbGbGbGbGbGbGbGbGbGbGbGbGbGbGbGbGbGbGbGbGbGbGbGbGbGbGbGbGbGbGbGbGbGbGbGbGbGbGbGbGbGbGbGbGbGbGbGbGbGbGbGbGbGbGbGbGbGbGbGbGbGbGbGbGbGbGbGbGbGbGbGbGbGbGbGbGbGbGbGbGbGbGbGbGbGbGbGbGbGbGbGbGbGbGbGbGbG
bGbGbGbGbGbGbGbGbGbGbGbGbGbGbGbGbGbGbGbGbGbGbGbGbGbGbGbGbGbGbGbGbGbGbGbGbGbGbGbGbGbGbGbGbGbGbGbGbGbGbGbGbGbGbGbGbGbGbGbGbGbGbGbGbGbGbGbGbGbGbGbGbGbGbGbGbGbGbGbGbGbGbGbGbGbGbGbGbGbGbGbGbGbGbGbGbGbGbGbG
bGbGbGbGbGbGbGbGbGbGbGbGbGbGbGbGbGbGbGbGbGbGbGbGbGbGbGbGbGbGbGbGbGbGbGbGbGbGbGbGbGbGbGbGbGbGbGbGbGbGbGbGbGbGbGbGbGbGbGbGbGbGbGbGbGbGbGbGbGbGbGbGbGbGbGbGbGbGbGbGbGbGbGbGbGbGbGbGbGbGbGbGbGbGbGbGbGbGbGbG
bGbGbGbGbGbGbGbGbGbGbGbGbGbGbGbGbGbGbGbGbGbGbGbGbGbGbGbGbGbGbGbGbGbGbGbGbGbGbGbGbGbGbGbGbGbGbGbGbGbGbGbGbGbGbGbGbGbGbGbGbGbGbGbGbGbGbGbGbGbGbGbGbGbGbGbGbGbGbGbGbGbGbGbGbGbGbGbGbGbGbGbGbGbGbGbGbGbGbGbG
bGbGbGbGbGbGbGbGbGbGbGbGbGbGbGbGbGbGbGbGbGbGbGbGbGbGbGbGbGbGbGbGbGbGbGbGbGbGbGbGbGbGbGbGbGbGbGbGbGbGbGbGbGbGbGbGbGbGbGbGbGbGbGbGbGbGbGbGbGbGbGbGbGbGbGbGbGbGbGbGbGbGbGbGbGbGbGbGbGbGbGbGbGbGbGbGbGbGbGbG
bGbGbGbGbGbGbGbGbGbGbGbGbGbGbGbGbGbGbGbGbGbGbGbGbGbGbGbGbGbGbGbGbGbGbGbGbGbGbGbGbGbGbGbGbGbGbGbGbGbGbGbGbGbGbGbGbGbGbGbGbGbGbGbGbGbGbGbGbGbGbGbGbGbGbGbGbGbGbGbGbGbGbGbGbGbGbGbGbGbGbGbGbGbGbGbGbGbGbGbG
bGbGbGbGbGbGbGbGbGbGbGbGbGbGbGbGbGbGbGbGbGbGbGbGbGbGbGbGbGbGbGbGbGbGbGbGbGbGbGbGbGbGbGbGbGbGbGbGbGbGbGbGbGbGbGbGbGbGbGbGbGbGbGbGbGbGbGbGbGbGbGbGbGbGbGbGbGbGbGbGbGbGbGbGbGbGbGbGbGbGbGbGbGbGbGbGbGbGbGbG
bGbGbGbGbGbGbGbGbGbGbGbGbGbGbGbGbGbGbGbGbGbGbGbGbGbGbGbGbGbGbGbGbGbGbGbGbGbGbGbGbGbGbGbGbGbGbGbGbGbGbGbGbGbGbGbGbGbGbGbGbGbGbGbGbGbGbGbGbGbGbGbGbGbGbGbGbGbGbGbGbGbGbGbGbGbGbGbGbGbGbGbGbGbGbGbGbGbGbGbG
bGbGbGbGbGbGbGbGbGbGbGbGbGbGbGbGbGbGbGbGbGbGbGbGbGbGbGbGbGbGbGbGbGbGbGbGbGbGbGbGbGbGbGbGbGbGbGbGbGbGbGbGbGbGbGbGbGbGbGbGbGbGbGbGbGbGbGbGbGbGbGbGbGbGbGbGbGbGbGbGbGbGbGbGbGbGbGbGbGbGbGbGbGbGbGbGbGbGbGbG
bGbGbGbGbGbGbGbGbGbGbGbGbGbGbGbGbGbGbGbGbGbGbGbGbGbGbGbGbGbGbGbGbGbGbGbGbGbGbGbGbGbGbGbGbGbGbGbGbGbGbGbGbGbGbGbGbGbGbGbGbGbGbGbGbGbGbGbGbGbGbGbGbGbGbGbGbGbGbGbGbGbGbGbGbGbGbGbGbGbGbGbGbGbGbGbGbGbGbGbG
bGbGbGbGbGbGbGbGbGbGbGbGbGbGbGbGbGbGbGbGbGbGbGbGbGbGbGbGbGbGbGbGbGbGbGbGbGbGbGbGbGbGbGbGbGbGbGbGbGbGbGbGbGbGbGbGbGbGbGbGbGbGbGbGbGbGbGbGbGbGbGbGbGbGbGbGbGbGbGbGbGbGbGbGbGbGbGbGbGbGbGbGbGbGbGbGbGbGbGbG
bGbGbGbGbGbGbGbGbGbGbGbGbGbGbGbGbGbGbGbGbGbGbGbGbGbGbGbGbGbGbGbGbGbGbGbGbGbGbGbGbGbGbGbGbGbGbGbGbGbGbGbGbGbGbGbGbGbGbGbGbGbGbGbGbGbGbGbGbGbGbGbGbGbGbGbGbGbGbGbGbGbGbGbGbGbGbGbGbGbGbGbGbGbGbGbGbGbGbGbG
bGbGbGbGbGbGbGbGbGbGbGbGbGbGbGbGbGbGbGbGbGbGbGbGbGbGbGbGbGbGbGbGbGbGbGbGbGbGbGbGbGbGbGbGbGbGbGbGbGbGFMFMFMXAFMFMFMFMFMFMXAFMFMFMFMFMFMXAFMFMFMFMFMFMXAFMFMFMbGbGbGbGbGbGbGbGbGbGbGbGbGbGbGbGbGbGbGbGbGbG
bGbGbGbGbGbGbGbGbGbGbGbGbGbGbGbGbGbGbGbGbGbGbGbGbGbGbGbGbGbGbGbGbGbGbGbGbGbGbGbGbGbGbGbGbGbGbGbGbGFMFMbGKkbGbGbGbGbGbGbGKkbGbGbGbGbGbGKkbGbGbGbGbGbGbGKkbGFMFMbGbGbGbGbGbGbGbGbGbGbGbGbGbGbGbGbGbGbGbGbG
bGbGbGbGbGbGbGbGbGbGbGbGbGbGbGbGbGbGbGbGbGbGbGbGbGbGbGbGbGbGbGbGbGbGbGbGbGbGbGbGbGbGbGbGbGbGbGbGXAFMbGndaIbGbGbGbGbGbGbGaIHJbGbGbGbGndaIbGbGbGbGbGbGbGaIHJbGFMXAbGbGbGbGbGbGbGbGbGbGbGbGbGbGbGbGbGbGbGbG
bGbGbGbGbGbGbGbGbGbGbGbGbGbGbGbGbGbGbGbGbGbGbGbGbGbGbGbGbGbGbGbGbGbGbGbGbGbGbGbGbGbGbGbGbGbGbGFMFMbGbGbGbGxAwtOmOmOmyPbGbGbGbGbGbGbGbGbGbGZkZkZkZkZkZkbGbGbGbGFMbGbGbGbGbGbGbGbGbGbGbGbGbGbGbGbGbGbGbGbG
bGbGbGbGbGbGbGbGbGbGbGbGbGbGbGbGbGbGbGbGbGbGbGbGbGbGbGbGbGbGbGbGbGbGbGbGbGbGbGbGbGbGbGbGbGbGFMFMbGbGbGbGbGxAwtYankEdOmOmbGbGbGbGbGbGbGbGZkZkZkZkZkZkZkbGbGbGbGFMbGbGbGbGbGbGbGbGbGbGbGbGbGbGbGbGbGbGbGbG
bGbGbGbGbGbGbGbGbGbGbGbGbGbGbGbGbGbGbGbGbGbGbGbGbGbGbGbGbGbGbGbGbGbGbGbGbGbGbGbGbGbGbGbGbGbGFMbGbGbGbGbGbGbGOmYanknkEdpmbGbGbGbGbGbGbGbGZkZkZkDkZkZkbGbGbGbGbGFMbGbGbGbGbGbGbGbGbGbGbGbGbGbGbGbGbGbGbGbG
bGbGbGbGbGbGbGbGbGbGbGbGbGbGbGbGbGbGbGbGbGbGbGbGbGbGbGbGbGbGbGbGbGbGbGbGbGbGbGbGbGbGbGbGbGbGFMbGbGbGbGbGbGZkwtYankEdOmOmbGbGbGbGbGbGbGbGZkZkZkZkZkZkZkbGbGbGbGFMbGbGbGbGbGbGbGbGbGbGbGbGbGbGbGbGbGbGbGbG
bGbGbGbGbGbGbGbGbGbGbGbGbGbGbGbGbGbGbGbGbGbGbGbGbGbGbGbGbGbGbGbGbGbGbGbGbGbGbGbGbGbGbGbGbGbGFMbGbGbGbGbGbGpzsPOmVaOmJsbGbGbGbGbGbGbGbGbGbGZkZkZkZkZkZkbGbGbGbGFMbGbGbGbGbGbGbGbGbGbGbGbGbGbGbGbGbGbGbGbG
bGbGbGbGbGbGbGbGbGbGbGbGbGbGbGbGbGbGbGbGbGbGbGbGbGbGbGbGbGbGbGbGbGbGbGbGbGbGbGbGbGbGbGbGbGbGFMbGbGbGbGndaIbGmwbGbGbGbGbGaIHJbGbGbGbGndaIbGbGbGbGbGbGbGaIHJbGbGXAbGbGbGbGbGbGbGbGbGbGbGbGbGbGbGbGbGbGbGbG
bGbGbGbGbGbGbGbGbGbGbGbGbGbGbGbGbGbGbGbGbGbGbGbGbGbGbGbGbGbGbGbGbGbGbGbGbGbGbGbGbGbGbGbGbGbGFMbGbGbGbGbGMbbGbGbGbGbGbGbGMbbGbGbGbGbGbGMbbGbGbGbGbGbGbGMbbGbGFMFMbGbGbGbGbGbGbGbGbGbGbGbGbGbGbGbGbGbGbGbG
bGbGbGbGbGbGbGbGbGbGbGbGbGbGbGbGbGbGbGbGbGbGbGbGbGbGbGbGbGbGbGbGbGbGbGbGbGbGbGbGbGbGbGbGbGbGFMbGbGbGJwvOdurQyAyAabbGbGbGbGbGbGbGbGbGbGbGbGbGbGbGbGbGbGbGbGbGFMbGbGbGbGbGbGbGbGbGbGbGbGbGbGbGbGbGbGbGbGbG
bGbGbGbGbGbGbGbGbGbGbGbGbGbGbGbGbGbGbGbGbGbGbGbGbGbGbGbGbGbGbGbGbGbGbGbGbGbGbGbGbGbGbGbGbGbGXAbGbGbGyAbhYXJIyAbhdubGbGbGbGbGbGbGbGbGbGbGbGbGbGbGbGbGbGbGbGbGXAbGbGbGbGbGbGbGbGbGbGbGbGbGbGbGbGbGbGbGbGbG
bGbGbGbGbGbGbGbGbGbGbGbGbGbGbGbGbGbGbGbGbGbGbGbGbGbGbGbGbGbGbGbGbGbGbGbGbGbGbGbGbGbGbGbGbGbGFMbGbGbGbGbGbGbGbGbGbGbGbGbGbGbGbGbGbGbGbGbGbGbGbGbGbGbGbGbGbGbGFMbGbGbGbGbGbGbGbGbGbGbGbGbGbGbGbGbGbGbGbGbG
bGbGbGbGbGbGbGbGbGbGbGbGbGbGbGbGbGbGbGbGbGbGbGbGbGbGbGbGbGbGbGbGbGbGbGbGbGbGbGbGbGbGbGbGbGbGFMbGbGbGbGbGbGbGbGbGbGbGbGbGbGbGbGbGbGbGbGbGbGbGbGbGbGbGbGbGbGbGFMbGbGbGbGbGbGbGbGbGbGbGbGbGbGbGbGbGbGbGbGbG
bGbGbGbGbGbGbGbGbGbGbGbGbGbGbGbGbGbGbGbGbGbGbGbGbGbGbGbGbGbGbGbGbGbGbGbGbGbGbGbGbGbGbGbGbGbGFMbGbGbGbGbGbGbGbGbGbGbGbGbGbGXAXAXAzRzRZTZTZTzRXAXAzRzRbGbGbGbGFMbGbGbGbGbGbGbGbGbGbGbGbGbGbGbGbGbGbGbGbGbG
bGbGbGbGbGbGbGbGbGbGbGbGbGbGbGbGbGbGbGbGbGbGbGbGbGbGbGbGbGbGbGbGbGbGbGbGbGbGbGbGbGbGbGbGbGbGFMbGLuXAAZAZAZtmtmEmLubGbGbGbGXAAPYRZTZTzRZTZTZTZTZTZTzRbGbGbGbGFMbGbGbGbGbGbGbGbGbGbGbGbGbGbGbGbGbGbGbGbGbG
bGbGbGbGbGbGbGbGbGbGbGbGbGbGbGbGbGbGbGbGbGbGbGbGbGbGbGbGbGbGbGbGbGbGbGbGbGbGbGbGbGbGbGbGbGbGFMbGbGDMbGbGbGbGbGbGbGbGbGbGbGXAZTZTvVZTXAkMZTZTKhcbZTzRbGbGbGbGFMbGbGbGbGbGbGbGbGbGbGbGbGbGbGbGbGbGbGbGbGbG
bGbGbGbGbGbGbGbGbGbGbGbGbGbGbGbGbGbGbGbGbGbGbGbGbGbGbGbGbGbGbGbGbGbGbGbGbGbGbGbGbGbGbGbGbGbGFMbGbGtPbGbGbGbGbGbGbGbGbGbGbGzRZTTrZTZTZTZTZTZTZTZTZTzRbGbGbGbGFMbGbGbGbGbGbGbGbGbGbGbGbGbGbGbGbGbGbGbGbGbG
bGbGbGbGbGbGbGbGbGbGbGbGbGbGbGbGbGbGbGbGbGbGbGbGbGbGbGbGbGbGbGbGbGbGbGbGbGbGbGbGbGbGbGbGbGbGFMbGbGoabGbGbGbGbGmwbGbGbGbGxGzRZTZTZTZTXAPaZTZTZTZTZTZTbGbGbGbGFMbGbGbGbGbGbGbGbGbGbGbGbGbGbGbGbGbGbGbGbGbG
bGbGbGbGbGbGbGbGbGbGbGbGbGbGbGbGbGbGbGbGbGbGbGbGbGbGbGbGbGbGbGbGbGbGbGbGbGbGbGbGbGbGbGbGbGbGFMbGbGmeUOWkWkWkzJLubGbGbGbGWTzRzRzRXAXAXAXAXAzRzRzRzRzRbGbGbGbGFMbGbGbGbGbGbGbGbGbGbGbGbGbGbGbGbGbGbGbGbGbG
bGbGbGbGbGbGbGbGbGbGbGbGbGbGbGbGbGbGbGbGbGbGbGbGbGbGbGbGbGbGbGbGbGbGbGbGbGbGbGbGbGbGbGbGbGbGFMbGbGoAoAWkWkWkzJLubGbGbGbGCJzRZTyCZTZTXAgDxMhhZTZTZTzRbGbGbGbGFMbGbGbGbGbGbGbGbGbGbGbGbGbGbGbGbGbGbGbGbGbG
bGbGbGbGbGbGbGbGbGbGbGbGbGbGbGbGbGbGbGbGbGbGbGbGbGbGbGbGbGbGbGbGbGbGbGbGbGbGbGbGbGbGbGbGbGbGFMbGbGoAbGbGbGbGbGmwbGbGbGbGZTkMZTZTPaZTXAczZzTrZTZTZTzRbGbGbGbGFMbGbGbGbGbGbGbGbGbGbGbGbGbGbGbGbGbGbGbGbGbG
bGbGbGbGbGbGbGbGbGbGbGbGbGbGbGbGbGbGbGbGbGbGbGbGbGbGbGbGbGbGbGbGbGbGbGbGbGbGbGbGbGbGbGbGbGbGXAbGbGoAbGbGbGbGbGbGbGbGbGbGbGzRZTixZTZTXAZTthViGPwDZTXAbGbGbGbGXAbGbGbGbGbGbGbGbGbGbGbGbGbGbGbGbGbGbGbGbGbG
bGbGbGbGbGbGbGbGbGbGbGbGbGbGbGbGbGbGbGbGbGbGbGbGbGbGbGbGbGbGbGbGbGbGbGbGbGbGbGbGbGbGbGbGbGbGFMbGbGoAbGbGbGbGbGbGbGbGbGbGbGXSZTKhZTZTkMvVZTGPxGssZTXAbGbGbGbGFMbGbGbGbGbGbGbGbGbGbGbGbGbGbGbGbGbGbGbGbGbG
bGbGbGbGbGbGbGbGbGbGbGbGbGbGbGbGbGbGbGbGbGbGbGbGbGbGbGbGbGbGbGbGbGbGbGbGbGbGbGbGbGbGbGbGbGbGFMbGLuXAayXCwTVWwmuxbGbGbGbGbGzRKhZTZTZnXAZTZTZTZTZTZTXAbGbGbGbGFMbGbGbGbGbGbGbGbGbGbGbGbGbGbGbGbGbGbGbGbGbG
bGbGbGbGbGbGbGbGbGbGbGbGbGbGbGbGbGbGbGbGbGbGbGbGbGbGbGbGbGbGbGbGbGbGbGbGbGbGbGbGbGbGbGbGbGbGFMbGbGbGbGbGbGbGbGbGbGbGbGbGbGzRzRXSzRzRzRzRzRXSXSzRXAXAVpbGbGbGFMFMbGbGbGbGbGbGbGbGbGbGbGbGbGbGbGbGbGbGbGbG
bGbGbGbGbGbGbGbGbGbGbGbGbGbGbGbGbGbGbGbGbGbGbGbGbGbGbGbGbGbGbGbGbGbGbGbGbGbGbGbGbGbGbGbGbGbGFMbGbGbGbGbGbGbGbGbGbGbGbGbGbGbGbGbGbGbGbGbGbGbGbGbGbGbGbGbGbGbGbGXAFMbGbGbGbGbGbGbGbGbGbGbGbGbGbGbGbGbGbGbG
bGbGbGbGbGbGbGbGbGbGbGbGbGbGbGbGbGbGbGbGbGbGbGbGbGbGbGbGbGbGbGbGbGbGbGbGbGbGbGbGbGbGbGbGbGbGFMbGbGKkbGbGbGbGbGbGbGbGbGbGbGbGbGbGbGbGbGbGbGbGbGbGbGbGbGbGbGbGKkbGFMFMbGbGbGbGbGbGbGbGbGbGbGbGbGbGbGbGbGbG
bGbGbGbGbGbGbGbGbGbGbGbGbGbGbGbGbGbGbGbGbGbGbGbGbGbGbGbGbGbGbGbGbGbGbGbGbGbGbGbGbGbGbGbGbGbGFMbGndaIbGbGbGbGbGbGbGbGbGbGbGbGbGbGbGbGbGbGbGbGbGbGbGbGbGbGbGbGaIHJbGFMbGbGbGbGbGbGbGbGbGbGbGbGbGbGbGbGbGbG
bGbGbGbGbGbGbGbGbGbGbGbGbGbGbGbGbGbGbGbGbGbGbGbGbGbGbGbGbGbGbGbGbGbGbGbGbGbGbGbGbGbGbGbGbGbGFMbGbGbGZkZkZkZkZkZkZkZkZkZkZkZkZkZkZkZkZkZkZkZkZkZkZkZkZkZkZkZkbGbGbGFMbGbGbGbGbGbGbGbGbGbGbGbGbGbGbGbGbGbG
bGbGbGbGbGbGbGbGbGbGbGbGbGbGbGbGbGbGbGbGbGbGbGbGbGbGbGbGbGbGbGbGbGbGbGbGbGbGbGbGbGbGbGbGbGbGFMbGbGbGZkZkZkZkZkZkZkZkZkZkZkZkZkZkZkZkZkZkZkZkZkZkZkZkZkZkZkZkbGbGbGFMbGbGbGbGbGbGbGbGbGbGbGbGbGbGbGbGbGbG
bGbGbGbGbGbGbGbGbGbGbGbGbGbGbGbGbGbGbGbGbGbGbGbGbGbGbGbGbGbGbGbGbGbGbGbGbGbGbGbGbGbGbGbGbGbGFMbGbGbGZkZkZkZkZkZkZkZkZkZkZkZkZkZkZkZkZkZkZkZkZkZkZkZkZkZkZkZkbGbGbGFMbGbGbGbGbGbGbGbGbGbGbGbGbGbGbGbGbGbG
bGbGbGbGbGbGbGbGbGbGbGbGbGbGbGbGbGbGbGbGbGbGbGbGbGbGbGbGbGbGbGbGbGbGbGbGbGbGbGbGbGbGbGbGbGbGFMbGbGbGZkZkZkZkZkZkZkZkZkZkZkZkZkZkZkZkZkZkZkZkZkZkZkZkZkZkZkZkbGbGbGFMbGbGbGbGbGbGbGbGbGbGbGbGbGbGbGbGbGbG
bGbGbGbGbGbGbGbGbGbGbGbGbGbGbGbGbGbGbGbGbGbGbGbGbGbGbGbGbGbGbGbGbGbGbGbGbGbGbGbGbGbGbGbGbGbGXAbGbGbGZkZkZkZkZkZkDkZkZkZkZkZkZkDkZkZkZkZkZkZkDkZkZkZkZkZkZkZkbGbGbGXAbGbGbGbGbGbGbGbGbGbGbGbGbGbGbGbGbGbG
bGbGbGbGbGbGbGbGbGbGbGbGbGbGbGbGbGbGbGbGbGbGbGbGbGbGbGbGbGbGbGbGbGbGbGbGbGbGbGbGbGbGbGbGbGbGFMbGbGbGZkZkZkZkZkZkZkZkZkZkZkZkZkZkZkZkZkZkZkZkZkZkZkZkZkZkZkZkbGbGbGFMbGbGbGbGbGbGbGbGbGbGbGbGbGbGbGbGbGbG
bGbGbGbGbGbGbGbGbGbGbGbGbGbGbGbGbGbGbGbGbGbGbGbGbGbGbGbGbGbGbGbGbGbGbGbGbGbGbGbGbGbGbGbGbGbGFMbGbGbGZkZkZkZkZkZkZkZkZkZkZkZkZkZkZkZkZkZkZkZkZkZkZkZkZkZkZkZkbGbGbGFMbGbGbGbGbGbGbGbGbGbGbGbGbGbGbGbGbGbG
bGbGbGbGbGbGbGbGbGbGbGbGbGbGbGbGbGbGbGbGbGbGbGbGbGbGbGbGbGbGbGbGbGbGbGbGbGbGbGbGbGbGbGbGbGbGFMbGbGbGZkZkZkZkZkZkZkZkZkZkZkZkZkZkZkZkZkZkZkZkZkZkZkZkZkZkZkZkbGbGbGFMbGbGbGbGbGbGbGbGbGbGbGbGbGbGbGbGbGbG
bGbGbGbGbGbGbGbGbGbGbGbGbGbGbGbGbGbGbGbGbGbGbGbGbGbGbGbGbGbGbGbGbGbGbGbGbGbGbGbGbGbGbGbGbGbGFMbGbGbGZkZkZkZkZkZkZkZkZkZkZkZkZkZkZkZkZkZkZkZkZkZkZkZkZkZkZkZkbGbGbGFMbGbGbGbGbGbGbGbGbGbGbGbGbGbGbGbGbGbG
bGbGbGbGbGbGbGbGbGbGbGbGbGbGbGbGbGbGbGbGbGbGbGbGbGbGbGbGbGbGbGbGbGbGbGbGbGbGbGbGbGbGbGbGbGbGFMbGndaIbGbGbGbGbGbGbGbGbGbGbGbGbGbGbGbGbGbGbGbGbGbGbGbGbGbGbGbGaIHJbGFMbGbGbGbGbGbGbGbGbGbGbGbGbGbGbGbGbGbG
bGbGbGbGbGbGbGbGbGbGbGbGbGbGbGbGbGbGbGbGbGbGbGbGbGbGbGbGbGbGbGbGbGbGbGbGbGbGbGbGbGbGbGbGbGbGXAFMbGbGbGbGbGbGbGbGbGbGbGbGbGbGbGbGbGbGbGbGbGbGbGbGbGbGbGbGbGbGbGbGFMXAbGbGbGbGbGbGbGbGbGbGbGbGbGbGbGbGbGbG
bGbGbGbGbGbGbGbGbGbGbGbGbGbGbGbGbGbGbGbGbGbGbGbGbGbGbGbGbGbGbGbGbGbGbGbGbGbGbGbGbGbGbGbGbGbGbGFMFMbGbGbGbGbGbGbGbGbGbGbGbGbGbGbGbGbGbGbGbGbGbGbGbGbGbGbGbGbGbGFMFMbGbGbGbGbGbGbGbGbGbGbGbGbGbGbGbGbGbGbG
bGbGbGbGbGbGbGbGbGbGbGbGbGbGbGbGbGbGbGbGbGbGbGbGbGbGbGbGbGbGbGbGbGbGbGbGbGbGbGbGbGbGbGbGbGbGbGbGXAFMFMFMFMXAFMFMFMFMFMFMXAFMFMFMFMFMFMXAFMFMFMFMFMFMXAFMFMFMFMXAbGbGbGbGbGbGbGbGbGbGbGbGbGbGbGbGbGbGbGbG
bGbGbGbGbGbGbGbGbGbGbGbGbGbGbGbGbGbGbGbGbGbGbGbGbGbGbGbGbGbGbGbGbGbGbGbGbGbGbGbGbGbGbGbGbGbGbGbGbGbGbGbGbGbGbGbGbGbGbGbGbGbGbGbGbGbGbGbGbGbGbGbGbGbGbGbGbGbGbGbGbGbGbGbGbGbGbGbGbGbGbGbGbGbGbGbGbGbGbGbG
bGbGbGbGbGbGbGbGbGbGbGbGbGbGbGbGbGbGbGbGbGbGbGbGbGbGbGbGbGbGbGbGbGbGbGbGbGbGbGbGbGbGbGbGbGbGbGbGbGbGbGbGbGbGbGbGbGbGbGbGbGbGbGbGbGbGbGbGbGbGbGbGbGbGbGbGbGbGbGbGbGbGbGbGbGbGbGbGbGbGbGbGbGbGbGbGbGbGbGbG
bGbGbGbGbGbGbGbGbGbGbGbGbGbGbGbGbGbGbGbGbGbGbGbGbGbGbGbGbGbGbGbGbGbGbGbGbGbGbGbGbGbGbGbGbGbGbGbGbGbGbGbGbGbGbGbGbGbGbGbGbGbGbGbGbGbGbGbGbGbGbGbGbGbGbGbGbGbGbGbGbGbGbGbGbGbGbGbGbGbGbGbGbGbGbGbGbGbGbGbG
bGbGbGbGbGbGbGbGbGbGbGbGbGbGbGbGbGbGbGbGbGbGbGbGbGbGbGbGbGbGbGbGbGbGbGbGbGbGbGbGbGbGbGbGbGbGbGbGbGbGbGbGbGbGbGbGbGbGbGbGbGbGbGbGbGbGbGbGbGbGbGbGbGbGbGbGbGbGbGbGbGbGbGbGbGbGbGbGbGbGbGbGbGbGbGbGbGbGbGbG
bGbGbGbGbGbGbGbGbGbGbGbGbGbGbGbGbGbGbGbGbGbGbGbGbGbGbGbGbGbGbGbGbGbGbGbGbGbGbGbGbGbGbGbGbGbGbGbGbGbGbGbGbGbGbGbGbGbGbGbGbGbGbGbGbGbGbGbGbGbGbGbGbGbGbGbGbGbGbGbGbGbGbGbGbGbGbGbGbGbGbGbGbGbGbGbGbGbGbGbG
bGbGbGbGbGbGbGbGbGbGbGbGbGbGbGbGbGbGbGbGbGbGbGbGbGbGbGbGbGbGbGbGbGbGbGbGbGbGbGbGbGbGbGbGbGbGbGbGbGbGbGbGbGbGbGbGbGbGbGbGbGbGbGbGbGbGbGbGbGbGbGbGbGbGbGbGbGbGbGbGbGbGbGbGbGbGbGbGbGbGbGbGbGbGbGbGbGbGbGbG
bGbGbGbGbGbGbGbGbGbGbGbGbGbGbGbGbGbGbGbGbGbGbGbGbGbGbGbGbGbGbGbGbGbGbGbGbGbGbGbGbGbGbGbGbGbGbGbGbGbGbGbGbGbGbGbGbGbGbGbGbGbGbGbGbGbGbGbGbGbGbGbGbGbGbGbGbGbGbGbGbGbGbGbGbGbGbGbGbGbGbGbGbGbGbGbGbGbGbGbG
bGbGbGbGbGbGbGbGbGbGbGbGbGbGbGbGbGbGbGbGbGbGbGbGbGbGbGbGbGbGbGbGbGbGbGbGbGbGbGbGbGbGbGbGbGbGbGbGbGbGbGbGbGbGbGbGbGbGbGbGbGbGbGbGbGbGbGbGbGbGbGbGbGbGbGbGbGbGbGbGbGbGbGbGbGbGbGbGbGbGbGbGbGbGbGbGbGbGbGbG
bGbGbGbGbGbGbGbGbGbGbGbGbGbGbGbGbGbGbGbGbGbGbGbGbGbGbGbGbGbGbGbGbGbGbGbGbGbGbGbGbGbGbGbGbGbGbGbGbGbGbGbGbGbGbGbGbGbGbGbGbGbGbGbGbGbGbGbGbGbGbGbGbGbGbGbGbGbGbGbGbGbGbGbGbGbGbGbGbGbGbGbGbGbGbGbGbGbGbGbG
bGbGbGbGbGbGbGbGbGbGbGbGbGbGbGbGbGbGbGbGbGbGbGbGbGbGbGbGbGbGbGbGbGbGbGbGbGbGbGbGbGbGbGbGbGbGbGbGbGbGbGbGbGbGbGbGbGbGbGbGbGbGbGbGbGbGbGbGbGbGbGbGbGbGbGbGbGbGbGbGbGbGbGbGbGbGbGbGbGbGbGbGbGbGbGbGbGbGbGbG
bGbGbGbGbGbGbGbGbGbGbGbGbGbGbGbGbGbGbGbGbGbGbGbGbGbGbGbGbGbGbGbGbGbGbGbGbGbGbGbGbGbGbGbGbGbGbGbGbGbGbGbGbGbGbGbGbGbGbGbGbGbGbGbGbGbGbGbGbGbGbGbGbGbGbGbGbGbGbGbGbGbGbGbGbGbGbGbGbGbGbGbGbGbGbGbGbGbGbGbG
bGbGbGbGbGbGbGbGbGbGbGbGbGbGbGbGbGbGbGbGbGbGbGbGbGbGbGbGbGbGbGbGbGbGbGbGbGbGbGbGbGbGbGbGbGbGbGbGbGbGbGbGbGbGbGbGbGbGbGbGbGbGbGbGbGbGbGbGbGbGbGbGbGbGbGbGbGbGbGbGbGbGbGbGbGbGbGbGbGbGbGbGbGbGbGbGbGbGbGbG
bGbGbGbGbGbGbGbGbGbGbGbGbGbGbGbGbGbGbGbGbGbGbGbGbGbGbGbGbGbGbGbGbGbGbGbGbGbGbGbGbGbGbGbGbGbGbGbGbGbGbGbGbGbGbGbGbGbGbGbGbGbGbGbGbGbGbGbGbGbGbGbGbGbGbGbGbGbGbGbGbGbGbGbGbGbGbGbGbGbGbGbGbGbGbGbGbGbGbGbG
bGbGbGbGbGbGbGbGbGbGbGbGbGbGbGbGbGbGbGbGbGbGbGbGbGbGbGbGbGbGbGbGbGbGbGbGbGbGbGbGbGbGbGbGbGbGbGbGbGbGbGbGbGbGbGbGbGbGbGbGbGbGbGbGbGbGbGbGbGbGbGbGbGbGbGbGbGbGbGbGbGbGbGbGbGbGbGbGbGbGbGbGbGbGbGbGbGbGbGbG
bGbGbGbGbGbGbGbGbGbGbGbGbGbGbGbGbGbGbGbGbGbGbGbGbGbGbGbGbGbGbGbGbGbGbGbGbGbGbGbGbGbGbGbGbGbGbGbGbGbGbGbGbGbGbGbGbGbGbGbGbGbGbGbGbGbGbGbGbGbGbGbGbGbGbGbGbGbGbGbGbGbGbGbGbGbGbGbGbGbGbGbGbGbGbGbGbGbGbGbG
bGbGbGbGbGbGbGbGbGbGbGbGbGbGbGbGbGbGbGbGbGbGbGbGbGbGbGbGbGbGbGbGbGbGbGbGbGbGbGbGbGbGbGbGbGbGbGbGbGbGbGbGbGbGbGbGbGbGbGbGbGbGbGbGbGbGbGbGbGbGbGbGbGbGbGbGbGbGbGbGbGbGbGbGbGbGbGbGbGbGbGbGbGbGbGbGbGbGbGbG
bGbGbGbGbGbGbGbGbGbGbGbGbGbGbGbGbGbGbGbGbGbGbGbGbGbGbGbGbGbGbGbGbGbGbGbGbGbGbGbGbGbGbGbGbGbGbGbGbGbGbGbGbGbGbGbGbGbGbGbGbGbGbGbGbGbGbGbGbGbGbGbGbGbGbGbGbGbGbGbGbGbGbGbGbGbGbGbGbGbGbGbGbGbGbGbGbGbGbGbG
bGbGbGbGbGbGbGbGbGbGbGbGbGbGbGbGbGbGbGbGbGbGbGbGbGbGbGbGbGbGbGbGbGbGbGbGbGbGbGbGbGbGbGbGbGbGbGbGbGbGbGbGbGbGbGbGbGbGbGbGbGbGbGbGbGbGbGbGbGbGbGbGbGbGbGbGbGbGbGbGbGbGbGbGbGbGbGbGbGbGbGbGbGbGbGbGbGbGbGbG
bGbGbGbGbGbGbGbGbGbGbGbGbGbGbGbGbGbGbGbGbGbGbGbGbGbGbGbGbGbGbGbGbGbGbGbGbGbGbGbGbGbGbGbGbGbGbGbGbGbGbGbGbGbGbGbGbGbGbGbGbGbGbGbGbGbGbGbGbGbGbGbGbGbGbGbGbGbGbGbGbGbGbGbGbGbGbGbGbGbGbGbGbGbGbGbGbGbGbGbG
bGbGbGbGbGbGbGbGbGbGbGbGbGbGbGbGbGbGbGbGbGbGbGbGbGbGbGbGbGbGbGbGbGbGbGbGbGbGbGbGbGbGbGbGbGbGbGbGbGbGbGbGbGbGbGbGbGbGbGbGbGbGbGbGbGbGbGbGbGbGbGbGbGbGbGbGbGbGbGbGbGbGbGbGbGbGbGbGbGbGbGbGbGbGbGbGbGbGbGbG
bGbGbGbGbGbGbGbGbGbGbGbGbGbGbGbGbGbGbGbGbGbGbGbGbGbGbGbGbGbGbGbGbGbGbGbGbGbGbGbGbGbGbGbGbGbGbGbGbGbGbGbGbGbGbGbGbGbGbGbGbGbGbGbGbGbGbGbGbGbGbGbGbGbGbGbGbGbGbGbGbGbGbGbGbGbGbGbGbGbGbGbGbGbGbGbGbGbGbGbG
bGbGbGbGbGbGbGbGbGbGbGbGbGbGbGbGbGbGbGbGbGbGbGbGbGbGbGbGbGbGbGbGbGbGbGbGbGbGbGbGbGbGbGbGbGbGbGbGbGbGbGbGbGbGbGbGbGbGbGbGbGbGbGbGbGbGbGbGbGbGbGbGbGbGbGbGbGbGbGbGbGbGbGbGbGbGbGbGbGbGbGbGbGbGbGbGbGbGbGbG
bGbGbGbGbGbGbGbGbGbGbGbGbGbGbGbGbGbGbGbGbGbGbGbGbGbGbGbGbGbGbGbGbGbGbGbGbGbGbGbGbGbGbGbGbGbGbGbGbGbGbGbGbGbGbGbGbGbGbGbGbGbGbGbGbGbGbGbGbGbGbGbGbGbGbGbGbGbGbGbGbGbGbGbGbGbGbGbGbGbGbGbGbGbGbGbGbGbGbGbG
bGbGbGbGbGbGbGbGbGbGbGbGbGbGbGbGbGbGbGbGbGbGbGbGbGbGbGbGbGbGbGbGbGbGbGbGbGbGbGbGbGbGbGbGbGbGbGbGbGbGbGbGbGbGbGbGbGbGbGbGbGbGbGbGbGbGbGbGbGbGbGbGbGbGbGbGbGbGbGbGbGbGbGbGbGbGbGbGbGbGbGbGbGbGbGbGbGbGbGbG
bGbGbGbGbGbGbGbGbGbGbGbGbGbGbGbGbGbGbGbGbGbGbGbGbGbGbGbGbGbGbGbGbGbGbGbGbGbGbGbGbGbGbGbGbGbGbGbGbGbGbGbGbGbGbGbGbGbGbGbGbGbGbGbGbGbGbGbGbGbGbGbGbGbGbGbGbGbGbGbGbGbGbGbGbGbGbGbGbGbGbGbGbGbGbGbGbGbGbGbG
bGbGbGbGbGbGbGbGbGbGbGbGbGbGbGbGbGbGbGbGbGbGbGbGbGbGbGbGbGbGbGbGbGbGbGbGbGbGbGbGbGbGbGbGbGbGbGbGbGbGbGbGbGbGbGbGbGbGbGbGbGbGbGbGbGbGbGbGbGbGbGbGbGbGbGbGbGbGbGbGbGbGbGbGbGbGbGbGbGbGbGbGbGbGbGbGbGbGbGbG
bGbGbGbGbGbGbGbGbGbGbGbGbGbGbGbGbGbGbGbGbGbGbGbGbGbGbGbGbGbGbGbGbGbGbGbGbGbGbGbGbGbGbGbGbGbGbGbGbGbGbGbGbGbGbGbGbGbGbGbGbGbGbGbGbGbGbGbGbGbGbGbGbGbGbGbGbGbGbGbGbGbGbGbGbGbGbGbGbGbGbGbGbGbGbGbGbGbGbGbG
bGbGbGbGbGbGbGbGbGbGbGbGbGbGbGbGbGbGbGbGbGbGbGbGbGbGbGbGbGbGbGbGbGbGbGbGbGbGbGbGbGbGbGbGbGbGbGbGbGbGbGbGbGbGbGbGbGbGbGbGbGbGbGbGbGbGbGbGbGbGbGbGbGbGbGbGbGbGbGbGbGbGbGbGbGbGbGbGbGbGbGbGbGbGbGbGbGbGbGbG
bGbGbGbGbGbGbGbGbGbGbGbGbGbGbGbGbGbGbGbGbGbGbGbGbGbGbGbGbGbGbGbGbGbGbGbGbGbGbGbGbGbGbGbGbGbGbGbGbGbGbGbGbGbGbGbGbGbGbGbGbGbGbGbGbGbGbGbGbGbGbGbGbGbGbGbGbGbGbGbGbGbGbGbGbGbGbGbGbGbGbGbGbGbGbGbGbGbGbGbG
bGbGbGbGbGbGbGbGbGbGbGbGbGbGbGbGbGbGbGbGbGbGbGbGbGbGbGbGbGbGbGbGbGbGbGbGbGbGbGbGbGbGbGbGbGbGbGbGbGbGbGbGbGbGbGbGbGbGbGbGbGbGbGbGbGbGbGbGbGbGbGbGbGbGbGbGbGbGbGbGbGbGbGbGbGbGbGbGbGbGbGbGbGbGbGbGbGbGbGbG
bGbGbGbGbGbGbGbGbGbGbGbGbGbGbGbGbGbGbGbGbGbGbGbGbGbGbGbGbGbGbGbGbGbGbGbGbGbGbGbGbGbGbGbGbGbGbGbGbGbGbGbGbGbGbGbGbGbGbGbGbGbGbGbGbGbGbGbGbGbGbGbGbGbGbGbGbGbGbGbGbGbGbGbGbGbGbGbGbGbGbGbGbGbGbGbGbGbGbGbG
bGbGbGbGbGbGbGbGbGbGbGbGbGbGbGbGbGbGbGbGbGbGbGbGbGbGbGbGbGbGbGbGbGbGbGbGbGbGbGbGbGbGbGbGbGbGbGbGbGbGbGbGbGbGbGbGbGbGbGbGbGbGbGbGbGbGbGbGbGbGbGbGbGbGbGbGbGbGbGbGbGbGbGbGbGbGbGbGbGbGbGbGbGbGbGbGbGbGbGbG
bGbGbGbGbGbGbGbGbGbGbGbGbGbGbGbGbGbGbGbGbGbGbGbGbGbGbGbGbGbGbGbGbGbGbGbGbGbGbGbGbGbGbGbGbGbGbGbGbGbGbGbGbGbGbGbGbGbGbGbGbGbGbGbGbGbGbGbGbGbGbGbGbGbGbGbGbGbGbGbGbGbGbGbGbGbGbGbGbGbGbGbGbGbGbGbGbGbGbGbG
bGbGbGbGbGbGbGbGbGbGbGbGbGbGbGbGbGbGbGbGbGbGbGbGbGbGbGbGbGbGbGbGbGbGbGbGbGbGbGbGbGbGbGbGbGbGbGbGbGbGbGbGbGbGbGbGbGbGbGbGbGbGbGbGbGbGbGbGbGbGbGbGbGbGbGbGbGbGbGbGbGbGbGbGbGbGbGbGbGbGbGbGbGbGbGbGbGbGbGbG
bGbGbGbGbGbGbGbGbGbGbGbGbGbGbGbGbGbGbGbGbGbGbGbGbGbGbGbGbGbGbGbGbGbGbGbGbGbGbGbGbGbGbGbGbGbGbGbGbGbGbGbGbGbGbGbGbGbGbGbGbGbGbGbGbGbGbGbGbGbGbGbGbGbGbGbGbGbGbGbGbGbGbGbGbGbGbGbGbGbGbGbGbGbGbGbGbGbGbGbG
bGbGbGbGbGbGbGbGbGbGbGbGbGbGbGbGbGbGbGbGbGbGbGbGbGbGbGbGbGbGbGbGbGbGbGbGbGbGbGbGbGbGbGbGbGbGbGbGbGbGbGbGbGbGbGbGbGbGbGbGbGbGbGbGbGbGbGbGbGbGbGbGbGbGbGbGbGbGbGbGbGbGbGbGbGbGbGbGbGbGbGbGbGbGbGbGbGbGbGbG
bGbGbGbGbGbGbGbGbGbGbGbGbGbGbGbGbGbGbGbGbGbGbGbGbGbGbGbGbGbGbGbGbGbGbGbGbGbGbGbGbGbGbGbGbGbGbGbGbGbGbGbGbGbGbGbGbGbGbGbGbGbGbGbGbGbGbGbGbGbGbGbGbGbGbGbGbGbGbGbGbGbGbGbGbGbGbGbGbGbGbGbGbGbGbGbGbGbGbGbG
bGbGbGbGbGbGbGbGbGbGbGbGbGbGbGbGbGbGbGbGbGbGbGbGbGbGbGbGbGbGbGbGbGbGbGbGbGbGbGbGbGbGbGbGbGbGbGbGbGbGbGbGbGbGbGbGbGbGbGbGbGbGbGbGbGbGbGbGbGbGbGbGbGbGbGbGbGbGbGbGbGbGbGbGbGbGbGbGbGbGbGbGbGbGbGbGbGbGbGbG
bGbGbGbGbGbGbGbGbGbGbGbGbGbGbGbGbGbGbGbGbGbGbGbGbGbGbGbGbGbGbGbGbGbGbGbGbGbGbGbGbGbGbGbGbGbGbGbGbGbGbGbGbGbGbGbGbGbGbGbGbGbGbGbGbGbGbGbGbGbGbGbGbGbGbGbGbGbGbGbGbGbGbGbGbGbGbGbGbGbGbGbGbGbGbGbGbGbGbGbG
bGbGbGbGbGbGbGbGbGbGbGbGbGbGbGbGbGbGbGbGbGbGbGbGbGbGbGbGbGbGbGbGbGbGbGbGbGbGbGbGbGbGbGbGbGbGbGbGbGbGbGbGbGbGbGbGbGbGbGbGbGbGbGbGbGbGbGbGbGbGbGbGbGbGbGbGbGbGbGbGbGbGbGbGbGbGbGbGbGbGbGbGbGbGbGbGbGbGbGbG
bGbGbGbGbGbGbGbGbGbGbGbGbGbGbGbGbGbGbGbGbGbGbGbGbGbGbGbGbGbGbGbGbGbGbGbGbGbGbGbGbGbGbGbGbGbGbGbGbGbGbGbGbGbGbGbGbGbGbGbGbGbGbGbGbGbGbGbGbGbGbGbGbGbGbGbGbGbGbGbGbGbGbGbGbGbGbGbGbGbGbGbGbGbGbGbGbGbGbGbG
bGbGbGbGbGbGbGbGbGbGbGbGbGbGbGbGbGbGbGbGbGbGbGbGbGbGbGbGbGbGbGbGbGbGbGbGbGbGbGbGbGbGbGbGbGbGbGbGbGbGbGbGbGbGbGbGbGbGbGbGbGbGbGbGbGbGbGbGbGbGbGbGbGbGbGbGbGbGbGbGbGbGbGbGbGbGbGbGbGbGbGbGbGbGbGbGbGbGbGbG
bGbGbGbGbGbGbGbGbGbGbGbGbGbGbGbGbGbGbGbGbGbGbGbGbGbGbGbGbGbGbGbGbGbGbGbGbGbGbGbGbGbGbGbGbGbGbGbGbGbGbGbGbGbGbGbGbGbGbGbGbGbGbGbGbGbGbGbGbGbGbGbGbGbGbGbGbGbGbGbGbGbGbGbGbGbGbGbGbGbGbGbGbGbGbGbGbGbGbGbG
bGbGbGbGbGbGbGbGbGbGbGbGbGbGbGbGbGbGbGbGbGbGbGbGbGbGbGbGbGbGbGbGbGbGbGbGbGbGbGbGbGbGbGbGbGbGbGbGbGbGbGbGbGbGbGbGbGbGbGbGbGbGbGbGbGbGbGbGbGbGbGbGbGbGbGbGbGbGbGbGbGbGbGbGbGbGbGbGbGbGbGbGbGbGbGbGbGbGbGbG
bGbGbGbGbGbGbGbGbGbGbGbGbGbGbGbGbGbGbGbGbGbGbGbGbGbGbGbGbGbGbGbGbGbGbGbGbGbGbGbGbGbGbGbGbGbGbGbGbGbGbGbGbGbGbGbGbGbGbGbGbGbGbGbGbGbGbGbGbGbGbGbGbGbGbGbGbGbGbGbGbGbGbGbGbGbGbGbGbGbGbGbGbGbGbGbGbGbGbGbG
"}
