"a" = (/turf/unsimulated/floor/frozenground,/area/polarplanet/street)
"d" = (/obj/structure/flora/tree/pine,/obj/structure/snow,/turf/unsimulated/floor/frozenground,/area/polarplanet/street)
"e" = (/obj/item/ammo_casing/shotgun/pellet/used,/turf/unsimulated/floor/frozenground,/area/polarplanet/street)
"f" = (/obj/structure/flora/tree/pine,/obj/structure/flora/grass/green,/obj/structure/flora/grass/green,/turf/unsimulated/floor/frozenground,/area/polarplanet/street)
"g" = (/obj/structure/flora/tree/pine,/obj/structure/flora/grass/brown,/turf/unsimulated/floor/frozenground,/area/polarplanet/street)
"h" = (/obj/structure/flora/grass/brown,/obj/structure/flora/grass/brown,/obj/structure/flora/grass/green,/turf/unsimulated/floor/frozenground,/area/polarplanet/street)
"k" = (/obj/structure/flora/grass/green,/turf/unsimulated/floor/frozenground,/area/polarplanet/street)
"l" = (/obj/structure/flora/tree/pine,/obj/structure/flora/grass/brown,/obj/structure/snow,/turf/unsimulated/floor/frozenground,/area/polarplanet/street)
"n" = (/obj/structure/flora/grass/brown,/obj/structure/flora/grass/green,/obj/structure/snow,/turf/unsimulated/floor/frozenground,/area/polarplanet/street)
"o" = (/obj/structure/flora/tree/pine,/turf/unsimulated/floor/frozenground,/area/polarplanet/street)
"p" = (/obj/effect/decal/cleanable/blood,/turf/unsimulated/floor/frozenground,/area/polarplanet/street)
"r" = (/mob/living/simple_animal/hostile/retaliate/beast/shantak,/obj/structure/snow,/turf/unsimulated/floor/frozenground,/area/polarplanet/street)
"s" = (/obj/structure/flora/grass/brown,/turf/unsimulated/floor/frozenground,/area/polarplanet/street)
"v" = (/obj/structure/flora/tree/pine,/obj/structure/flora/grass/green,/turf/unsimulated/floor/frozenground,/area/polarplanet/street)
"x" = (/obj/item/gun/projectile/shotgun/pump,/obj/item/ammo_casing/shotgun/pellet/used,/obj/effect/decal/cleanable/blood,/turf/unsimulated/floor/frozenground,/area/polarplanet/street)
"D" = (/obj/item/ammo_casing/shotgun/pellet/used,/obj/structure/snow,/turf/unsimulated/floor/frozenground,/area/polarplanet/street)
"F" = (/obj/structure/snow,/turf/unsimulated/floor/frozenground,/area/polarplanet/street)
"G" = (/obj/item/device/flashlight{on = 1},/turf/unsimulated/floor/frozenground,/area/polarplanet/street)
"I" = (/obj/structure/flora/grass/green,/obj/structure/flora/grass/green,/turf/unsimulated/floor/frozenground,/area/polarplanet/street)
"K" = (/obj/structure/flora/tree/pine,/obj/structure/flora/grass/green,/obj/structure/snow,/turf/unsimulated/floor/frozenground,/area/polarplanet/street)
"L" = (/obj/item/ammo_casing/shotgun/pellet,/turf/unsimulated/floor/frozenground,/area/polarplanet/street)
"Q" = (/obj/effect/decal/cleanable/blood,/obj/structure/snow,/turf/unsimulated/floor/frozenground,/area/polarplanet/street)
"S" = (/obj/structure/flora/grass/brown,/obj/structure/flora/grass/brown,/turf/unsimulated/floor/frozenground,/area/polarplanet/street)
"T" = (/obj/structure/flora/grass/brown,/obj/structure/flora/grass/brown,/obj/structure/snow,/turf/unsimulated/floor/frozenground,/area/polarplanet/street)
"U" = (/obj/structure/flora/grass/brown,/obj/structure/flora/grass/green,/turf/unsimulated/floor/frozenground,/area/polarplanet/street)
"X" = (/obj/structure/flora/grass/brown,/obj/structure/snow,/turf/unsimulated/floor/frozenground,/area/polarplanet/street)
"Y" = (/obj/structure/flora/grass/green,/obj/structure/snow,/turf/unsimulated/floor/frozenground,/area/polarplanet/street)
"Z" = (/obj/structure/flora/tree/pine,/obj/structure/flora/grass/brown,/obj/structure/flora/grass/green,/turf/unsimulated/floor/frozenground,/area/polarplanet/street)

(1,1,1) = {"
aaaaaaaaaaaaaaaaaaaaaaaaaaaaaaaaaaaaaaaaaaaaaaaaaa
aaaaaaaaaaaaaaaaaaaaaaaaaaaaaaaaaaaaaaaaaaaaaaaaaa
aaaaaaaaaaaaaaaaaaaaaaaaaaaaaaaaaaaaaaaaaaaaaaaaaa
aaaaaaaaaaaaaaaaaaaaaaaaaaaaaaaaaaaaaaaaaaaaaaaaaa
aaaaaaaaaaaaaaaaaaaaaaaaaaaaFFaaaFaaaaaaaaaaaaaaaa
aaaaaaaaaaaaaFFFaaaaaaaaaaZaaXFKFFFakaaaaaaaaaaaaa
aaaaaaaaaaaaFFFFaaaaaaaaakasaFYFFFaaakaaaaaaaaaaaa
aaaaaaaaaaaaaFdFFFFFFaasaaaaoaFYFFaoaFFaaaaaaaaaaa
aaaaaaaaaaaaaFaFFYFUFFFFFvaaaaaaasaaadFFaaaaaaaaaa
aaaaaaaaaaaaaFFFFaFaFFFFFaaaaaakaagaaFFFaaaaaaaaaa
aaaaaaaaaaaFFFdFsFaaoaFFFFaaaoaaoaasaFFYFaaaaaaaaa
aaaaaaaaFFFFFXFaaaFaaaakaaalaaaaYaasaaFFFaaaaaaaaa
aaaaaaFFFFXFaafaaoaaaasaaaaaasFFFaoasaaFFaaaaaaaaa
aaaaasXFFFFdFYXsFasaasavaaaaaFFXFaaasoaaakaaaaaaaa
aaaaaaFXXFFFFFXsaaFagskaaoaaFFaaasagaaaaakkaaaaaaa
aaaaaaFFFFFYaaaFassaakaaosaoFFaaFFaaaFFaoaaaaaaaaa
aaaaaaaaaoaksosasoXsvaaaaaaaFXoaXFasaFFaaaaaaaaaaa
aaaaaaaoaaaaaaaFasakaaaaaaFFFFFFFFaaaXFXaaaaaaaaaa
aaaaaaaakaaaoaaaSaaaaaaaaFFFFDFFFFoFFFFFFoaFaaaaaa
aaaaaaakaaaaasassasasaaoaFFFFFFFaaaFFFFFFaaFFaaaaa
aaaaaaaaaaaagaFaaaaoaaosaFFFFFFFaaaaFaaaaaaFFFaaaa
aaaaaaoaFaaaaFFFaaaFFFFFFFFFFFXFsZUaYkoaaaFFFFaaaa
aaaaaaaFFaaaFFFFoFFFFFFFFFFQFFFkkasaFaaaaoFFFFaaaa
aaaaaFFFFFoaFFFFFFFFFFaFFFFFFFYaaaaaaaaaaaFFFaaaaa
aaaaFFFFFFFaFFFFFFFaaaaaFDFFFYFaaaosaaasasFFFaaaaa
aaaFFFFFFFFFaaaaFaaaaaoFFFFFFFFaasaSsasaXXFFFdaaaa
aaaFFFFFrFFFFsosasossvaFFFFFFsaaaaFkaasadFFFFFFaaa
aaaaFFFFFFFFaaaaaFsFkaFFFFFFFaaoaaFasgFaFFFFFFFaaa
aaaaXFFFFFFaaoaaFSaaaaFaFFFFFaaksFXaaaFaFFFFFFFFaa
aaoaXaFFFaaaaasaXsaXasFaaaFFFaUaakFaFaaaFFFFFFFaaa
aaaaFXFaaoaaagFFaaaaoaeaosFXFsZUaYYoaaaaFFFFFFFaaa
aaaaFlYaaaaaaaFFaaaaFFasaaFFYkasaFFFFaoaFFFFFFaaFa
aaaaFFFFaaaaaaaaaoaLaFFFFFFYaaFFFFFFFFaaFFFFFFaFaa
aaaFFFXYsasosFaaaapxeFFFFFYFaaaosFFFXasaFFFFFaaaaa
aaFFFFFFkaaFkaFoFaGaakaaaaaaaasFTXasassFFFdaaaaaaa
aaFFFFFFXkaaFFFFasFFFasaIksaaaFFYFasaoaFFFFFaaaaaa
aaFFdFFFaakXXFnFFaaaaaaoaYFaoFFFFsgFFFFFFFFFFFaaaa
aaaFFFYaosaaaFFXaFaaaoaakFFakXFXFaaFFFFFFFFFFFaaaa
aaaFFFFFaaokaFFsaaoaasFXssaUaFYFaFaFFFFFFFFFFFaFaa
aaaFFFFYFFaaXaaaUaaksFFFFsgkakaaXFaFFFFFdFFFaFaFaa
aaaaFFFaaFFFaUaaoaaaaFFFaFasskaaFFaaaaaFFFFaaaaaaa
aaaaFFFvaFXFaasaaskoaFFFaaFkassaFraaaoaFFFFaaaaaaa
aaaaaFFFYYFFaFagFaaUaaFYoakaIaoXaaFoFaFFFaFaaaFaaa
aaaaaFdFFFYFoaFYXFsahUsXFnToaaaaFXaFaaFFFFFFFaaaaa
aaaaaFFFFaFnaaFFFaUsosknXFYsnnFFFFaFFFFFFFFFFaaaaa
aaaaaFFFFaFFkaaFaaaUoaoakFkaFdXFlFFFnFdFFFYdFaaaaa
aaaaaaaFFdFasgakaaYYsaaaakFFFYFYFFsFFFFFYFFFFaFFaa
aaaaaaaaaaaaaasoYdFYFsvkokFFYFFFFFaaFaFFaFFaaaFFaa
aaaaaaaaaaaaagaasFFFFFasaaaaaaaaaaaaaaaaaaFaFaFdaa
aaaaaaaaaaaaaaaaFFFFaaaaaaaaaaaaaaaaaaaaaaaaaFaaaa
"}
