"a" = (/turf/unsimulated/floor/frozenground,/area/polarplanet/street)
"d" = (/obj/structure/flora/tree/pine,/obj/structure/snow,/turf/unsimulated/floor/frozenground,/area/polarplanet/street)
"f" = (/obj/structure/flora/tree/pine,/obj/structure/flora/grass/green,/obj/structure/flora/grass/green,/turf/unsimulated/floor/frozenground,/area/polarplanet/street)
"g" = (/obj/structure/flora/tree/pine,/obj/structure/flora/grass/brown,/turf/unsimulated/floor/frozenground,/area/polarplanet/street)
"h" = (/obj/structure/flora/grass/brown,/obj/structure/flora/grass/brown,/obj/structure/flora/grass/green,/turf/unsimulated/floor/frozenground,/area/polarplanet/street)
"j" = (/obj/structure/flora/grass/brown,/obj/structure/flora/grass/green,/obj/structure/flora/grass/green,/turf/unsimulated/floor/frozenground,/area/polarplanet/street)
"k" = (/obj/structure/flora/grass/green,/turf/unsimulated/floor/frozenground,/area/polarplanet/street)
"l" = (/obj/structure/flora/tree/pine,/obj/structure/flora/grass/brown,/obj/structure/snow,/turf/unsimulated/floor/frozenground,/area/polarplanet/street)
"n" = (/obj/structure/flora/grass/brown,/obj/structure/flora/grass/green,/obj/structure/snow,/turf/unsimulated/floor/frozenground,/area/polarplanet/street)
"o" = (/obj/structure/flora/tree/pine,/turf/unsimulated/floor/frozenground,/area/polarplanet/street)
"p" = (/obj/structure/flora/grass/green,/obj/structure/snow,/obj/structure/snow,/turf/unsimulated/floor/frozenground,/area/polarplanet/street)
"s" = (/obj/structure/flora/grass/brown,/turf/unsimulated/floor/frozenground,/area/polarplanet/street)
"v" = (/obj/structure/flora/tree/pine,/obj/structure/flora/grass/green,/turf/unsimulated/floor/frozenground,/area/polarplanet/street)
"x" = (/obj/structure/flora/grass/green,/obj/structure/flora/grass/green,/obj/structure/flora/grass/green,/turf/unsimulated/floor/frozenground,/area/polarplanet/street)
"A" = (/mob/living/simple_animal/hostile/tree,/obj/structure/snow,/turf/unsimulated/floor/frozenground,/area/polarplanet/street)
"D" = (/obj/structure/flora/tree/pine,/obj/structure/flora/grass/brown,/obj/structure/flora/grass/green,/obj/structure/snow,/turf/unsimulated/floor/frozenground,/area/polarplanet/street)
"F" = (/obj/structure/snow,/turf/unsimulated/floor/frozenground,/area/polarplanet/street)
"G" = (/obj/structure/gravemarker/cross,/turf/unsimulated/floor/frozenground,/area/polarplanet/street)
"I" = (/obj/structure/flora/grass/green,/obj/structure/flora/grass/green,/turf/unsimulated/floor/frozenground,/area/polarplanet/street)
"K" = (/obj/structure/flora/tree/pine,/obj/structure/flora/grass/green,/obj/structure/snow,/turf/unsimulated/floor/frozenground,/area/polarplanet/street)
"N" = (/obj/structure/flora/grass/green,/obj/structure/flora/grass/green,/obj/structure/snow,/turf/unsimulated/floor/frozenground,/area/polarplanet/street)
"P" = (/obj/structure/flora/grass/green,/obj/structure/snow,/turf/unsimulated/floor/frozenground,/area/polarplanet/street)
"Q" = (/obj/structure/flora/tree/pine,/obj/structure/snow,/obj/structure/snow,/turf/unsimulated/floor/frozenground,/area/polarplanet/street)
"S" = (/obj/structure/flora/grass/brown,/obj/structure/flora/grass/brown,/turf/unsimulated/floor/frozenground,/area/polarplanet/street)
"T" = (/obj/structure/flora/grass/brown,/obj/structure/flora/grass/brown,/obj/structure/snow,/turf/unsimulated/floor/frozenground,/area/polarplanet/street)
"U" = (/obj/structure/flora/grass/brown,/obj/structure/flora/grass/green,/turf/unsimulated/floor/frozenground,/area/polarplanet/street)
"X" = (/obj/structure/flora/grass/brown,/obj/structure/snow,/turf/unsimulated/floor/frozenground,/area/polarplanet/street)
"Y" = (/obj/structure/snow,/obj/structure/snow,/turf/unsimulated/floor/frozenground,/area/polarplanet/street)
"Z" = (/obj/structure/flora/tree/pine,/obj/structure/flora/grass/brown,/obj/structure/flora/grass/green,/turf/unsimulated/floor/frozenground,/area/polarplanet/street)

(1,1,1) = {"
aaaaaaaaaaaaaaaaaaaaaaaaaaaaaaaaaaaaaaaaaaaaaaaaaa
aaasaaaaaaaaaaaaFFFFFFFFFaaFFFFFFFFFaaaaaaaaaaaaaa
aoasaaaaaaaFFFFFFFFFFFFFFFFFFFFFFFFFFFaaaaaaaaaaaa
aaaasaaFdFFFFFFFFFFdFFFdXFXFXDnFPkdFFFFaaaaaaaaaaa
aaaagkFFFFFFPFFFFFFFXXXFFFFPPasFFFFFFQYaaaaaaaaaaa
aaaaaFFFFFFFFFPFFXFXFFFFFFPFFaaaFFFaaFFaaaaaaaaaaa
aaaaFXPXFXdXFXXFFPFFFdFFaPFFFaosFFFsaXFFFaaaaaaaaa
aaaaFFFPFFFPFFdFFFFFPFFFaaaaaXFTXasasXFFFoaaaaaaaa
aaaaFFFXPFFFFFFFsFFFasaIksaaFFFPFasaoaFFFFaaaaaaaa
aaadFFFFFPXsFnFFaaFFaadFPaFoFFFFXlFFFFFFFFaaaaaaaa
aaaFFPFdXFFFFFsaaaFFoaFPFaakXFXFFFFFFFFFFFaaaaaaaa
aaFFFFFFFdPFFasaaoaasaXsXaUaFPFFFFFFFFFFFFaaaaaaaa
aaFFFFPFFFFXFFaUaaksFFFasgkaPFFXFFFFFFFdFFaaaaaaaa
aFFFFFFFFFFFUaaoaaaaaFFaaasskaFFFFFFFFFFFFFaaaaaaa
aFFFFFKFFXFaasaaskoaFFaaaakassaaFFFFdFFFFFFaaaaaaa
aFFFFFFPPFFaaagaaaUaFFkoakaIaosaFFdFFFFFFFFFaaaaaa
aaFFFdFFFkaoaakXFsahUssaUSoaaaaasFFFFaFFFFFFaaaaaa
aaaFFFFFFaUaaaFFFUsoskUsaksUUaaaaFFFFaFFFFFFFaaaaa
aaaaFFFFFaFkaaaaaaUoaoakakaaosagaFFnFoaaFPdFFaaaaa
aaaaaFFFdFFsgakaakPXaaaakaFakakaaXFFFaaPFFFFFFaaaa
aaaaaFFFFFFaasokoaPFsvkokaFPaakkaasaaasFFFFFFFaaaa
aaaaaaFFFaaagaFskaIFaasaaaaFaaaPIFkIasFFFFFFFFdaaa
aaaaaaFFFaaasaFaaasxPPaaosasndFFssaavFPFPPPFPPaaaa
aaaaaaaFFoaaaoaaoasaPFskakaFXFFFPaGsaFPXFdFFFFaaaa
aaaaaaaFFFFFFXFFFFgIFFFaaagaPnFTssskaFFFFFFFFFFaaa
aaaaaaaaFFFFFXFFFFskjaakdkaPFPFPaaFaaoFFFFXFFFFaaa
aaaaaaaFFFFFFFXXFFdnFkaNFFakaaaaoaaaaaadFFFXFFdaaa
aaaaaaaFFFFFFFdFXFFFFZaFFFssoFaaFaaaFaaFFFFFaaaaaa
aaaaaaFFFFFFFFFFXXFFFkkkPaoassaaaaaFFFFFFFFFFaaaaa
aaaaaFFFFFFFFFFFFnFFUkasUaasskaaaoaFFAFFFFFFFFaaaa
aaaaaFFFFFFFFFFFFFoaaasaaoaasaaaFaaFFFFFFFFFFFFaaa
aaaaaaFFFFFFFFFFdFkssFvaaUasaaoaaaaFFFFFFFFFFFdaaa
aaaaaaaFFFFdFFFFFFaasaakaUaaaPFFFFdFFFFFFFFFFFFaaa
aaaaaaaaFFFFFFpFnaFaaaasFksoFFFFFFFFFFFFFFFFFFaaaa
aaaaaaaaaaFFFFFFFaaaFsaaasksaFFFFFFFFFFFFFFFFaaaaa
aaaaaaaaaaFdFsaaFoFaaZaasavaFFFPFFFFFFFFFFFFaaaaaa
aaaaaaaaaFXaaaaaFaaFkasaakaaaaaakFFFFFFFFFFFaaaaaa
aaaaaFFXaFFfFaoaFaasaaadaakaaaoaaFFFFFFFFFFFaaaaaa
aassFFFaoakssaFsaasavaaaaaaasaaaoFFFFFFFFFFaaaaaaa
aFFFssaaaaassaaaagskaaaaaakaagFFFFFFFFFFFFFaaaaaaa
aFFFaaaakaaaFassaakFFaaaoaaoaaXFFFPFFFFFFFaaaaaaaa
FFFFaaoaksdsasossvFaaagaFFFkaasaaFFFFFFFFaaaaaaaaa
FFFFoaaaaaaaFasakaaFFaaaXFFaaoasaFFFFFFFaaaaaaaaaa
FFFFYPFFFoaaaSaaaaaaaaaFFFXaaaasoFFFPFFaaaaaaaaaaa
FFFFPFFFFFXFXXFXFXFFdaaFFaaFXFlFFFFFPPFaaaaaaaaaaa
aFFFFFFFFlFFFFFFdFFdXaoaaFaFFFFFFFFdFFFaaaaaaaaaaa
aaFdFFFFFFFFFFFFFFFFFFFFsoaXFFXFFFFFFFaaaaaaaaaaaa
aaFFFFFFFFFFFdFFFFFFFFFFaaaaaaFFXFXaaaaaaaaaaaaaaa
aaaaFFFdFFFFFFFFFFFFaaaaaaaaaoFFFFFaoaaaaaaaaaaaaa
aaaaaaaFFFFFFFFFaaoaaaaaaaaaaaaaaaaaaaaaaaaaaaaaaa
"}
