"a" = (/turf/unsimulated/floor/frozenground,/area/polarplanet/street)
"c" = (/obj/structure/snow,/mob/living/simple_animal/hostile/retaliate/beast/shantak,/turf/unsimulated/floor/frozenground,/area/polarplanet/street)
"d" = (/obj/structure/flora/tree/pine,/obj/structure/snow,/turf/unsimulated/floor/frozenground,/area/polarplanet/street)
"f" = (/obj/structure/flora/tree/pine,/obj/structure/flora/grass/green,/obj/structure/flora/grass/green,/turf/unsimulated/floor/frozenground,/area/polarplanet/street)
"g" = (/obj/structure/flora/tree/pine,/obj/structure/flora/grass/brown,/turf/unsimulated/floor/frozenground,/area/polarplanet/street)
"h" = (/obj/structure/flora/grass/brown,/obj/structure/flora/grass/brown,/obj/structure/flora/grass/green,/turf/unsimulated/floor/frozenground,/area/polarplanet/street)
"i" = (/obj/effect/landmark/corpse/russian/ranged,/turf/unsimulated/floor/frozenground,/area/polarplanet/street)
"j" = (/obj/structure/flora/grass/brown,/obj/structure/flora/grass/green,/obj/structure/flora/grass/green,/turf/unsimulated/floor/frozenground,/area/polarplanet/street)
"k" = (/obj/structure/flora/grass/green,/turf/unsimulated/floor/frozenground,/area/polarplanet/street)
"l" = (/obj/structure/flora/tree/pine,/obj/structure/flora/grass/brown,/obj/structure/snow,/turf/unsimulated/floor/frozenground,/area/polarplanet/street)
"m" = (/mob/living/simple_animal/hostile/retaliate/beast/shantak,/obj/structure/snow,/turf/unsimulated/floor/frozenground,/area/polarplanet/street)
"n" = (/obj/structure/flora/grass/brown,/obj/structure/flora/grass/green,/obj/structure/snow,/turf/unsimulated/floor/frozenground,/area/polarplanet/street)
"o" = (/obj/structure/flora/tree/pine,/turf/unsimulated/floor/frozenground,/area/polarplanet/street)
"p" = (/mob/living/simple_animal/hostile/tree,/turf/unsimulated/floor/frozenground,/area/polarplanet/street)
"q" = (/obj/item/gun/projectile/automatic/as75,/turf/unsimulated/floor/frozenground,/area/polarplanet/street)
"r" = (/obj/structure/snow,/obj/structure/flora/grass/green,/turf/unsimulated/floor/frozenground,/area/polarplanet/street)
"s" = (/obj/structure/flora/grass/brown,/turf/unsimulated/floor/frozenground,/area/polarplanet/street)
"t" = (/obj/effect/decal/cleanable/blood,/obj/structure/snow,/turf/unsimulated/floor/frozenground,/area/polarplanet/street)
"u" = (/mob/living/simple_animal/hostile/bear,/turf/unsimulated/floor/frozenground,/area/polarplanet/street)
"v" = (/obj/structure/flora/tree/pine,/obj/structure/flora/grass/green,/turf/unsimulated/floor/frozenground,/area/polarplanet/street)
"w" = (/obj/structure/snow,/turf/unsimulated/floor/frozenground,/area/polarplanet/street)
"x" = (/obj/structure/flora/grass/green,/obj/structure/flora/grass/green,/obj/structure/flora/grass/green,/turf/unsimulated/floor/frozenground,/area/polarplanet/street)
"y" = (/obj/structure/flora/tree/pine,/obj/structure/snow,/turf/unsimulated/floor/frozenground,/area/polarplanet/street)
"z" = (/obj/item/gun/projectile/shotgun/doublebarrel/sawn,/turf/unsimulated/floor/frozenground,/area/polarplanet/street)
"A" = (/mob/living/simple_animal/hostile/tree,/obj/structure/snow,/turf/unsimulated/floor/frozenground,/area/polarplanet/street)
"B" = (/obj/item/ammo_casing/shotgun/pellet/used,/obj/structure/snow,/turf/unsimulated/floor/frozenground,/area/polarplanet/street)
"C" = (/obj/item/device/flashlight{on = 1},/turf/unsimulated/floor/frozenground,/area/polarplanet/street)
"D" = (/obj/structure/flora/tree/pine,/obj/structure/flora/grass/brown,/obj/structure/flora/grass/green,/obj/structure/snow,/turf/unsimulated/floor/frozenground,/area/polarplanet/street)
"E" = (/obj/item/ammo_casing/shotgun/pellet,/obj/effect/decal/cleanable/blood,/turf/unsimulated/floor/frozenground,/area/polarplanet/street)
"F" = (/obj/structure/snow,/turf/unsimulated/floor/frozenground,/area/polarplanet/street)
"G" = (/obj/structure/gravemarker/cross,/turf/unsimulated/floor/frozenground,/area/polarplanet/street)
"H" = (/obj/effect/landmark/corpse/russian,/turf/unsimulated/floor/frozenground,/area/polarplanet/street)
"I" = (/obj/structure/flora/grass/green,/obj/structure/flora/grass/green,/turf/unsimulated/floor/frozenground,/area/polarplanet/street)
"J" = (/obj/item/ammo_casing/shotgun/pellet/used,/obj/effect/decal/cleanable/blood,/turf/unsimulated/floor/frozenground,/area/polarplanet/street)
"K" = (/obj/structure/flora/tree/pine,/obj/structure/flora/grass/green,/obj/structure/snow,/turf/unsimulated/floor/frozenground,/area/polarplanet/street)
"L" = (/obj/structure/snow,/mob/living/simple_animal/hostile/tree,/turf/unsimulated/floor/frozenground,/area/polarplanet/street)
"N" = (/obj/structure/flora/grass/green,/obj/structure/flora/grass/green,/obj/structure/snow,/turf/unsimulated/floor/frozenground,/area/polarplanet/street)
"O" = (/obj/item/ammo_casing/shotgun/pellet/used,/turf/unsimulated/floor/frozenground,/area/polarplanet/street)
"P" = (/obj/structure/flora/grass/green,/obj/structure/snow,/turf/unsimulated/floor/frozenground,/area/polarplanet/street)
"Q" = (/obj/structure/snow,/obj/structure/flora/grass/brown,/turf/unsimulated/floor/frozenground,/area/polarplanet/street)
"R" = (/obj/effect/decal/cleanable/blood,/turf/unsimulated/floor/frozenground,/area/polarplanet/street)
"S" = (/obj/structure/flora/grass/brown,/obj/structure/flora/grass/brown,/turf/unsimulated/floor/frozenground,/area/polarplanet/street)
"T" = (/obj/structure/flora/grass/brown,/obj/structure/flora/grass/brown,/obj/structure/snow,/turf/unsimulated/floor/frozenground,/area/polarplanet/street)
"U" = (/obj/structure/flora/grass/brown,/obj/structure/flora/grass/green,/turf/unsimulated/floor/frozenground,/area/polarplanet/street)
"W" = (/obj/structure/snow,/obj/item/ammo_casing/shotgun/pellet/used,/turf/unsimulated/floor/frozenground,/area/polarplanet/street)
"X" = (/obj/structure/flora/grass/brown,/obj/structure/snow,/turf/unsimulated/floor/frozenground,/area/polarplanet/street)
"Y" = (/obj/structure/flora/grass/green,/obj/structure/snow,/turf/unsimulated/floor/frozenground,/area/polarplanet/street)
"Z" = (/obj/structure/flora/tree/pine,/obj/structure/flora/grass/brown,/obj/structure/flora/grass/green,/turf/unsimulated/floor/frozenground,/area/polarplanet/street)

(1,1,1) = {"
aaaaaaaaaaaaaaaaaaFFFFFXFFFFskjaakdkaPFPFPaaFaaoFFFFXFFFFaaaFFFFaaaaaaaaaaaaaaaaaaaaaaaaaaaaaaaaaaFF
aaaaaaaaaaaaaaaaaFFFFFFFXXFFdnFkaNFFakaaaaoaaaaaadFFFXFFdaaFFFFFaaaaaaaaaaaaaaaaoaaaaaFFaaasaaaaaaFF
aaaaaaaaaaaaaaaaaFFFFFFFdFXFFFFZaFFFssoFaaFaaaFaaFFFFFaaaaaFFFFFaaFFFFFKFFXFaasaaskoaFFaaaakaaaaaaaF
aaaaaaaaaaaaaaaaFFFFFFFFFFXXFFFkkkPaoassaaaaaFFFFFFFFFFaaaaFFFFaaaFFFFFFPPFFaaagaaaUaFFkoakaaaaaaaaF
aaaaaaaaaaaaaaaFFFFFFFFFFFFnFFUkasUaasskaaaoaFFAFFFFFFFFaaaFFFFaaaaFFFdFFFkaoaakXFsahUssaUSoaaaaaaaa
aaaaaaaaaaaaaaaFFFFFFFFFFFFFoaaasaaoaasaaaFaaFFFFFFFFFFFFaaaFFFFaaaaFFFFFFaUaaaFFFUsoskUsaksaaaaaaaF
aaaaaaaaaaaaaaaaFFFFFFFFFFdFkssFvaaUasaaoaaaaFFFFrrFFFFFdaaaFFrFFaaaaFFFFFaFkaaaaaaUoaoakakaaaaaaaaF
aaaaaaaaaaaaaaaaaFFFFdFFFFFFaasaakaUaaaPFFFFdFFFrrFFFFFFFaaaFrrFFFaaaaFFFdFFsgakaakPXaaaakaFaaaaaaFF
aaaaaaaaaaaaaaaaaaFFFFFFYFnaFaaaasFksoFFFFFFFFFFrFFFFFFFaaaFFrFFFFaaaaFFFFFFaasokoaPFsvkokaFaaaaaaaa
aaaaaaaaaaaaaaaaaaaaFFFFFFFaaaFsaaasksaFFFFFFFFFFFFFFFFaaaaFFrFFFFFFaaaFFFaaagaFskaIFaasaaaaaaaaasaa
aaaaaaaaaaaaaaaaaaaaFdFsaaFoFaaZaasavaFFFPFFFFFrFFFFFFaaaaFFFFFFFFFFFaaFFFaaasaFaaasxPPaaosaaaaoasaa
aaaaaaaaaaaaaaaaaaaFXaaaaaFaaFkasaakaaaaaakFFFFrFFFFFFaaaaFFFFFFFFFFFaaaFFoaaaoaaoasaPFskakaaaaaaasa
aaaaaaaaaaaaaaaFFXaFFfFaoaFaasaaadaakaaaoaaFFFFFFFFFFFaaaFFFFaaaaaaaFaaaFFFFFFXFFFFgIFFFaaagaaaaaagk
aaaaaaaaaaaassFFFaoakssaFsaasavaaaaaaasaaaoFFFFFFFFFFaaaFFFFFaaaaaaaaaaaaFFFFFXFFFFskjaakdkaaaaaaaaF
aaaaaaaaaaaFFFssaaaaassaaaagskaaaaaakaagFFFFFFFFFFFFFaaFFFFFaaaaaaaaaaaaFFFFFFFXXFFdnFkaNFFaaaaaaaFX
aaaaaaaaaaaFFFaaaakaaaFassaakFFaaaoaaoaaXFFFPFFFFFFFaaFFFFFFaaoaaaaaaaaaFFFFFFFdFXFFFFZaFFFsaaaaaaFF
aaaaaaaaaaFFFFaaoaksLsasossvFaaagaFFFkaasaaFFFFFFFFaaaFFFFFaaaFaaaaaaaaFFFFFFFFFFXXFFFkkkPaoaaaaaaFF
aaaaaaaaaaFFFFoaaaaaaaFasakaaFFaaaXFFaaoasaFFFFFFFaaaFFFFFaaaaaaaaaaaaFFFFFFFFFFFFnFFUkasUaaaaaaadFF
aaaaaaaaaaFFFFwPFFFoaaaSaaaaaaaaaFFFXaaaasoFFFPFFaaaaFFFFFaaaaaoaaaaaaFFFFFFFFFFFFFoaaasaaoaaFaaaFFP
aaaaaaaaaaFFFFPFFFFFXFXXFXFXFFdaaFFaaFXFlFFFFFPPFaaaaFFFFFaaaaFaaaaaaaaFFFFFFFFFFdFkssFvaaUaaFaaFFFF
aaaaaaaaaaaFFFFFFFFlFFFFFFdFFdXaoaaFaFFFFFFFFdFFFaaaFFFFFaaapaaaaaaaaaaaFFFaaaaaaaaaaaaaaaaaaaaaaaaa
aaaaaaaaaaaaFdFFFFFFFFFFFFFFFFFFFFsoaXFFXFFFFFFFaaaFFFFFaaaaFFFFdaaaaaaaaFFaaasaaaaaaaaaaaaFFFFFFFFF
aaaaaaaaaaaaFFFFFFFFFFFdFFFFFFFFFFaaaaaaFFXFXaaaaaaFFFaaaaaaFFFFFaaaaaaaaaaaoasaaaaaaaFFFFFFFFFFFFFF
aaaaaaaaaaaaaaFFFdFFFFFFFFFFFFaaaaaaaaaoFFFFFaoaaaaaaaaaaaaaFFFFFaaaaaaaaaaaaaasaaFdFFFFFFFFFFdFFFdX
aaaaaaaaaaaaaaaaaFFFFFFFFFaaoaaaaaaaaaaaaaaaaaaaaaaaaaaaaaaaFPFFFaaaaaaaaaFaaaagkFFFFFFPFFFFFFFXXXFF
aaaaaaaaaaaaaaaaaaaaaaaaaaaaaaaaaaaaaaaFXaaaaaFaaFkasaakaaaaaakFFaaaaaFFXaFaaaaaFFFFFFFFFPFFXFXFFFFF
aaaaaaaaaaaaaaaaaaaaaaaaaaaaaaaaaaaFFXaFFfFaoaFaasaaadaakaaaoaaFFaassFFFaoaaaaaFXPXFXdXFXXFFPFFFdFFa
aaaaaaaaaaaaaaaaaaaaaaaaaaaaaaaassFFFaoakssaFsaasavaaaaaaasaaaoFFaFFFssaaaaaaaaFFFPFFFPFFdFFFFFPFFFa
aaaaaaaaaaaaaaaaaaaaaaaaaaaaaaaFFFssaaaaassaaaagskaaaaaakaagFFFFFaFFFaaaakaaaaaFFFXPFFFFFFFsFFFasaIk
aaaaaaaaaaaaaaaaaaaaaaaaaaaaaaaaaaaaaaaaaaaaaaaaaaaaaaaaaaaaaaaaaaaaaaaaaksaaadFFFFFPXsFnFFaaFFaadFP
aaaaaaaaaaaaaaaaaaaaaaaaaaaaaaaaaaaaaaaaaaaaaaaaaaaaaaaaaaaaaaaaaaaaaaaaaaaaaaFFPFdXFFFFFsaaaFFoaFPF
aaaaaaaaaaaaaaaaaaaaaaaaaaaaaaaaaaaaaaaaaaaaaaaaaaaaaaaaaaaaaaaaaaaaaaaaFFoaaFFFFFFFdPFFasaaoaasaXsX
aaaaaaaaaaaaaaaaaaaaaaaaaaaaaaaaaaaaaaaaaaaaaaaaaaaaaaaaaaaaaaaaaaaaaaaaFFFaaFFFFPFFFFXFFaUaaksFFFas
aaaaaaaaaaaaaaaaaaaaasaaaaaaaaaaaaaaaaaaaaaaaaaaaaFFaaaFaaaaaaaaaaaaaaaaFFlaFFFFFFFFFFFUaaoaaaaaFFaa
aaaaaaaaaaaaaaaaaaaoasaaaaaaaaaaaaaFFFaaaaaaaaaaZaaXFKFFFakaaaaaaaaaaaaaaaaaaaaaaaaaaaaaaaaaaaaaaaaa
aaaaaaaaaaaaaaaaaaaaaaaaaaaaaaaaaaFFFFaaaaaaaaakasaFPFFFaaakaaaaaaFFaaaaaaaaaaaaFFFFFFFFFFFFFFFFFFFa
aaaaaaaaaaaaaaaaaaaaaaaaaaaaaaaaaaaFdFFFFFFaasaaaaoaFPFFaoaFFaaaaaaFaaaaaaaaaaaFFFFFFFFFFFFFFFFFFFFF
aaaaaaaaaaaaaaaaaaaaaaaaaaaaFFaaaaaFaFFPFUFFFFFvaaaaaaasaaadFFaaaaaFFaaaaaaaaaaaaaaaaaaaaaFFFFFFFFFF
aaaaaaaaaaaaaaaaasaaaaaaaaaaFaaaaaaFFFFaFaFFFFFaaaaaakaagaaFFFaaaaaaFFaaFFFFFaaFFFFFFFFFaaaaaFFFFFFF
aaaaaaaaaaaaaaaoasaaaaaaaaFFFaaaaFFFdFsFaaoaFFFFaaaoaaoaasaFFPFaaaaaaFFFFFFFFFFFFFFFFFFFFFaaaaFFFFFF
aaaaaaaaaaaaaaaaaasaaFFaaaFFaaFFFFFXFaaaFaaaakaaalaaaaPaasaaFFFaaaFaaaFFFFFdXFXFXDnFPkdFFFFaaaFFFFFF
aaaaaaaaaaaaaaaaaagkFFFFaaFFFFFFXFaafaaoaaaasaaaaaasFFFaoasaaFFaaaFaaFFFXXXFFFFPPasFFFFFFywaaaaFFFFa
aaaaaaaaaaaaaaaaaaaFFFFFaaFXXFFFFdFPXsFasaasavaaaaaFFXFaaasoaaakaaaFaFaFFFFFFFPFFaaaFFFaaFFaaaaFFFFa
aaaaaaaaaaaaaaaaaaFXPXFFFaFFFXXFFFFFXsaaFagskaaoaaFFaaasagaaaaakkaaFwaaaaaaaaaaaaaaaaaaaaXFFFaaFFFFF
aaaaaaaaaaaaaaaaaaFFFPaFFFFFFFFFFPaaaFassaakaaosaoFFaaFFaaaFFaoaaaaawFaaFFaaaaaaaaaaaaaasXFFFoaFFFFF
aaaaaaaaaaaaaaaaaaFFFXaaFFFFaaaoaksosasoXsvaaaaaaaFXoaXFasaFFaaaaaaFFFFaFFFFaaaaaaaaaaaaoaFFFFaaFFFF
aaaaaaaaaaaaaaaaadFFFFaaFFFFaoaaaaaaaFasakaaaaaaFFFFFFFFaaaXFXaaaaFFaaFFdFFFFaaaaaaaaaaaFFFFFFaaFFFF
aaaaaaaaaaaaaaaaaFFPFdaaFFFFaakaaaoaaaSaaaaaaaaFFFFBFFFFoFFFFFFoaFaaaaaFFFFywaaaauaaaaaaFFFFFFaaFFFF
aaaaaaaaaaaaaaaaFFFFFFFFFFFaakaaaaasassasasaaoaFFFFFFFaaaFFFFFFaaFFaaaFFFaaFFaaaaOzHaaaaFFFFFFaaaFFF
aaaaaaaaaaaaaaaaFFFFPFFFFFFaaaaaaagaFaaaaoaaosaFFFFFFFaaaaFaaaaaaFFFaFFaFsaXFWFaaaaiaaaaFFFdFFaaaFFF
aaaaaaaaaaaaaaaFFFFFFFFFFFFaoaFaaaaFFFaaaFFFFFFFFFFFXFsZUaPkoaaaFFWFaFFFsasXFFFoaaHqaaaaFFFFFFFaaFFF
aaaaaaaaaaaaaaaFFFFFKFFFFaaaaFFaaaFFFFoFFFFFFFFcFtFFFkkasaFaaaaoFFFFFFFWsRoaWFFFaaaaauaadFFFFFFaaaFF
aaaaaaaaaaaaaaaFFFFFFPaaFaaFFFFFoaFFFFFFFFFFaFFFFFFFPaaaaaaaaaRaFFFaFFFFFFFFFFFFaaaaaaaaFFFFFFFFaaaF
aaaaaaaaaaaaaaaaFFFdFFaFFaFFFFFFFaFFFFFFFaaaaaFBFFFPFaaaosaRasasFFFaFFaFFFFFFFFFaaaaaaaaFaFFFFFFaaaF
aaaaaaaaaaaaaaaaaFFFFFaFaFFFFFFFFFaaaaFaaaaaoFFFFFFFFaasaSsasaXXFFFdaaaFFFFFFFFFaaaaaaaaFaFFFFFFFaaF
aaaaaaaaaaaaaaaaaaFFFFFaaFFFFFmFFFFsosasossvaFFFFFFsaaaaFkaasadFFFFFFaaFFFFFFdFFaaaaaaaaFoaaFPdFFaaa
aaaaaaaaaaaaaaaaaaaFFFFaaaFFFFFFFFaaaaaFsFkaFFFFFFFaaoaaFasgFaFFFFFFFaaaFFFFFFFFFaaaaaaaFaaPFFFFFFaa
aaaaaaaaaaaaaaaaaaaFFFFFaaXFFFFFFaaoaaFSaaaaFaFFFFFaaksFXaaaFaFFFFFFFFaaFFdFFFFFFaaaaaaaaasFFFFFFFaa
aaaaaaaaaaaaaaaaaaaaFFaFoaXaFFFaaaaasaXsaXasFaaaFFFaUaakFaFaaaFFFFFFFaaadFFFFFFFFFaaaaaaasFFFFFFFFda
aaaaaaaaaaaaaaaaaaaaFFaFaaFXFapaaaagFFaaaaoaJaosFXFsZUaPPoaaaaFFFFFFFaaaFFFaFFFFFFaaaaaavFPFPPPFPPaa
aaaaaaaaaaaaaaaaaaaaaFaFaaFlPaaaaaaaFFaaaaFFasaaFFPkasaFFFFaoaFFFFFFaaFaFFFaFFFFFFFaaaaaaFPXFdFFFFaa
aaaaaaaaaaaaaaaaaaaaaFFFaaFFFFaaaaaaaaaoaEaFFFFFFPaaFFFFcFFFaaFFFFFFaFaaFnFoaaFPdFFaaaaaaFFFFFFFFFFa
aaaaaaaaaaaaaaaaaaaaaaFaaFFFXPsasosFaaaaRJOFFFFFPFaaaosFFFXasaFFFFFaaaaaFFFaaPFFFFFFaaaaaoFFFFXFFFFa
aaaaaaaaaaaaaaaaaaaaaFFaFFFFFFkaaFkaFoFaCaakaaaaaaaasFTXasassFFFdaaaaaaasaaasFFFFFFFaaaaaaadFFFXFFda
aaaaaaaaaaaaaaaaaaaaaFFFFFFFFFXkaaFFFFasFFFasaIksaaaFFPFasaoaFFFFFaaaaaakIasFFFFFFFFdaaaFaaFFFFFaaaa
aaaaaaaaaaaaaaaaaaaaFFaFFFdFFFaakXXFnFFaaaaaaoaPFaoFFFFsgFFFFFFFFFFFaaaaaavFPFPPPFPPaaaaFFFFFFFFFaaa
aaaaaaaaaaaaaaaaaaaFFFaFaFFFPaosaaaFFXaFaaaoaakFFakXFXFaaFFFFFFFFFFFaaaaGsaFPXFdFFFFaaaaFAFFFFFFFFaa
aaaaaaaaaaaaaaaaaaaFFFFFaFFFFFaaokaFFsaaoaasFXssaUaFPFaFaFFFFcFFFFFFaFaaskaFFFFFFFFFFaaaFFFFFFFFFFFa
aaaaaaaaaaaaaaaaaaaaFFFaaFFFFPFFaaXaaaUaaksFFFFsgkakaaXFaFFFFFdFFFaFaFaaFaaoFFFFXFFFFaaaFFFFFFFFFFda
aaaaaaaaaaaaaaaaaaaaaFaaaaFFFaaFFFaUaaoaaaaFFFaFasskaaFFaaaaaFFFFaaaaaaaaaaaadFFFXFFdaaaFFFFFFFFFFFa
aaaaaaaaaaaaaaaaaaaaaaaaaaFFFvaFXFaasaaskoaFFFaaFkassaFmaaaoaFFFFaaaaaaaaaFaaFFFFFaaaaaaFFFFFFFFFFaa
aaaaaaaaaaaaaaaaaaaaaaaaaaaFFFPPFFaFagFaaUaaFPoakaIaoXaaFoFaFFFaFaaaFaaaaFFFFFFFFFFaaaaaFFFFFFFFFaaa
aaaaaaaaaaaaaaaaaaaaaaaaaaaFdFFFPFoaFPXFsahUsXFnToaaaaFXaFaaFFFFFFFaaaaaaFFAFFFFFFFFaaaaFFFFFFFFaaaa
aaaaaaaaaaaaaaaaaaaaaaaaaaaFFFFaFnaaFFFaUsosknXFPsnnFFFFaFFFFFFFFFFaaaaaaFFFFFFFFFFFFaaaFFFFFFFFaaaa
aaaaaaaaaaaaaaaaaaaFFXaaaaaFFFFaFFkaaFaaaUoaoakFkaFdXFlFFFnFdFFFPdFaaaaaaFFFFFFFFFFFdaaaFFFFFFFFaaaa
aaaaaaaaaaaaaaaassFFFaaaaaaaaFFdFasgakaaPPsaaaakFFFPFPFFsFFFFFPFFFFaFFaadFFFFQQQQQFFFaaaFFFFFFFaaaaa
aaaaaaaaaaaaaaaFFFssaaaaaaaaaaaaaaaasoPdFPFsvkokFFPFFFFFaaFaFFaFFaaaFFaaFFFFFQFFFFFFaaaaFFFFFFFaaaaa
aaaaaaaaaaaaaaaFFFaaaaaaaaaaaaaaaaagaasFFFFFasaaaaaaaaaaaaaaaaaaFaFaFdaaFFFFQFFFFFFaaaaaFFFFFFaaaaaa
aaaaaaaaaaaaaaFFFFaaoaaaaaaaaaaaaaaaaaFFFFaaaaaaaaaaaaaaaaaaaaaaaaaFaaaaFFFQFFFQFFaaaaaaFFFFFaaaaaaa
aaaaaaaaaaaaaaFFFFoaaaaaaaFasakaaFFaaaXFFaaoasaFFFFFFFaaaaaaaaaaaaaaaakFFFQQFFQFFFaaaaaaFFFFaaaaaaaa
aaaaaaaaaaaaaaFFFFwPFFFoaaaSaaaaaaaaaFFFXaaaasoFFFPFFaaaaaaaaaaakaaaoaaFFFFFFQFFFFaaaaaaPFFaaaaaaaaa
aaaaaaaaaaaaaaFFFFPFFFFFXFXXFXFXFFdaaFFaaFXFlFFFFFPPFaaaaaaaaaaaaasaaaoFFFFFQQFFFaaaaaaaPPFaaaaaaaaa
aaaaaaaaaaaaaaaFFFFFFFFlFFFFFFdFFdXaoaaFaFFFFFFFFdFFFaaaaaaaoaaakaagFFFFFFFFFFFFFaaaaaaaFFFaaaaaaaaa
aaaaaaaaaaaaaaaaFdFFFFFFFFFFFFFFFFFFFFsoaXFFXFFFFFFFaaaaaaaaaaaaaoaaXFFFPFFFFFFFaaaaaaaaFFaaaaaaaaaa
aaaaaaaaaaaaaaaaFFFFFFFFFFFdFFFFFFFFFFaaaaaaFFXFXaaaaaaaaaoaaaaaFkaasaaFFFFFFFFaaaaaaaaaaaaaaaaaaaaa
aaaaaaaaaaaaaaaaaaFFFdFFFFFFFFFFFFaaaaaaaaaoFFFFFaoaaaaaaaaaaaaaFaaoasaFFFFFFFaaaaaaaaaaoaaaaaaaaaaa
aaaaaaaaaaaaaaaaaaaaaFFFFFFFFFaaoaaaaaaaaaaaaaaaaaaaaaaaaaaaaaaaXaaaasoFFFPFFaaaaaaaaaaaaaaaaaaaaaaa
aaaaaaaaaaaaaaaaaaaaaaaaaaaaaaaaaaaaaaFFFFPFFFFFXFXXFXFXFFdaaFFaaFXFlFFFFFPPFaaaaaaaaaaaaaaaaaaaaaaa
aaaaaaaaaaaaaaaaaaaaaaaaaaaaaaaaaaaaaaaFFFFFFFFlFFFFFFdFFdXaoaaFaFFFFFFFFdFFFaaaaaaaaaaaaaaaaaaaaaaa
aaaaaaaaaaaaaaaaaaaaaaaaaaaaaaaaaaaaaaaaFdFFFFFFFFFFFFFFFFFFFFsoaXFFXFFFFFFFaaaaaaaaaaaaaaaaaaaaaaaa
aaaaaaaaaaaaaaaaaaaaaaaaaaaaaaaaaaaaaaaaFFFFFFFFFFFdFFFFFFFFFFaaaaaaFFXFXaaaaaaaaaaaaaaaaaaaaaaaaaaa
aaaaaaaaaaaaaaaaaaaaaaaaaaaaaaaaaaaaaaaaaaFFFdFFFFFFFFFFFFaaaaaaaaaoFFFFFaoaaaaaaaaaaaaaaaaaaaaaaaaa
aaaaaaaaaaaaaaaaaaaaaaaaaaaaaaaaaaaaaaaaaaaaaFFFFFFFFFaaoaaaaaaaaaaaaaaaaaaaaaaaaaaaaaaaaaaaaaaaaaaa
aaaaaaaaaaaaaaaaaaaaaaaaaaaaaaaaaaaaaaaaaaaaaaaaaaaaaaaaaaaaaaaaaaaaaaaaaaaaaaaaaaaaaaaaaaaaaaaaaaaa
aaaaaaaaaaaaaaaaaaaaaaaaaaaaaaaaaaaaaaaaaaaaaaaaaaaaaaaaaaaaaaaaaaaaaaaaaaaaaaaaaaaaaaaaaaaaaaaaaaaa
aaaaaaaaaaaaaaaaaaaaaaaaaaaaaaaaaaaaaaaaaaaaaaaaaaaaaaaaaaaaaaaaaaaaaaaaaaaaaaaaaaaaaaaaaaaaaaaaaaaa
aaaaaaaaaaaaaaaaaaaaaaaaaaaaaaaaaaaaaaaaaaaaaaaaaaaaaaaaaaaaaaaaaaaaaaaaaaaaaaaaaaaaaaaaaaaaaaaaaaaa
aaaaaaaaaaaaaaaaaaaaaaaaaaaaaaaaaaaaaaaaaaaaaaaaaaaaaaaaaaaaaaaaaaaaaaaaaaaaaaaaaaaaaaaaaaaaaaaaaaaa
aaaaaaaaaaaaaaaaaaaaaaaaaaaaaaaaaaaaaaaaaaaaaaaaaaaaaaaaaaaaaaaaaaaaaaaaaaaaaaaaaaaaaaaaaaaaaaaaaaaa
aaaaaaaaaaaaaaaaaaaaaaaaaaaaaaaaaaaaaaaaaaaaaaaaaaaaaaaaaaaaaaaaaaaaaaaaaaaaaaaaaaaaaaaaaaaaaaaaaaaa
"}
