"a" = (/turf/unsimulated/floor/frozenground,/area/polarplanet/street)
"d" = (/obj/structure/flora/tree/pine,/obj/structure/snow,/turf/unsimulated/floor/frozenground,/area/polarplanet/street)
"f" = (/obj/structure/flora/tree/pine,/obj/structure/flora/grass/green,/obj/structure/flora/grass/green,/turf/unsimulated/floor/frozenground,/area/polarplanet/street)
"g" = (/obj/structure/flora/tree/pine,/obj/structure/flora/grass/brown,/turf/unsimulated/floor/frozenground,/area/polarplanet/street)
"h" = (/obj/structure/flora/grass/brown,/obj/structure/flora/grass/brown,/obj/structure/flora/grass/green,/turf/unsimulated/floor/frozenground,/area/polarplanet/street)
"j" = (/obj/structure/flora/grass/brown,/obj/structure/flora/grass/green,/obj/structure/flora/grass/green,/turf/unsimulated/floor/frozenground,/area/polarplanet/street)
"k" = (/obj/structure/flora/grass/green,/turf/unsimulated/floor/frozenground,/area/polarplanet/street)
"l" = (/obj/structure/flora/tree/pine,/obj/structure/flora/grass/brown,/obj/structure/snow,/turf/unsimulated/floor/frozenground,/area/polarplanet/street)
"n" = (/obj/structure/flora/grass/brown,/obj/structure/flora/grass/green,/obj/structure/snow,/turf/unsimulated/floor/frozenground,/area/polarplanet/street)
"o" = (/obj/structure/flora/tree/pine,/turf/unsimulated/floor/frozenground,/area/polarplanet/street)
"r" = (/obj/structure/snow,/obj/structure/flora/grass/green,/turf/unsimulated/floor/frozenground,/area/polarplanet/street)
"s" = (/obj/structure/flora/grass/brown,/turf/unsimulated/floor/frozenground,/area/polarplanet/street)
"v" = (/obj/structure/flora/tree/pine,/obj/structure/flora/grass/green,/turf/unsimulated/floor/frozenground,/area/polarplanet/street)
"w" = (/obj/structure/snow,/turf/unsimulated/floor/frozenground,/area/polarplanet/street)
"x" = (/obj/structure/flora/grass/green,/obj/structure/flora/grass/green,/obj/structure/flora/grass/green,/turf/unsimulated/floor/frozenground,/area/polarplanet/street)
"y" = (/obj/structure/flora/tree/pine,/obj/structure/snow,/turf/unsimulated/floor/frozenground,/area/polarplanet/street)
"A" = (/mob/living/simple_animal/hostile/tree,/obj/structure/snow,/turf/unsimulated/floor/frozenground,/area/polarplanet/street)
"B" = (/turf/unsimulated/floor/frozenground,/turf/unsimulated/floor/frozenground,/area/polarplanet/street)
"D" = (/obj/structure/flora/tree/pine,/obj/structure/flora/grass/brown,/obj/structure/flora/grass/green,/obj/structure/snow,/turf/unsimulated/floor/frozenground,/area/polarplanet/street)
"F" = (/obj/structure/snow,/turf/unsimulated/floor/frozenground,/area/polarplanet/street)
"G" = (/obj/structure/gravemarker/cross,/turf/unsimulated/floor/frozenground,/area/polarplanet/street)
"I" = (/obj/structure/flora/grass/green,/obj/structure/flora/grass/green,/turf/unsimulated/floor/frozenground,/area/polarplanet/street)
"K" = (/obj/structure/flora/tree/pine,/obj/structure/flora/grass/green,/obj/structure/snow,/turf/unsimulated/floor/frozenground,/area/polarplanet/street)
"N" = (/obj/structure/flora/grass/green,/obj/structure/flora/grass/green,/obj/structure/snow,/turf/unsimulated/floor/frozenground,/area/polarplanet/street)
"P" = (/obj/structure/flora/grass/green,/obj/structure/snow,/turf/unsimulated/floor/frozenground,/area/polarplanet/street)
"Q" = (/obj/structure/snow,/obj/structure/flora/grass/brown,/turf/unsimulated/floor/frozenground,/area/polarplanet/street)
"S" = (/obj/structure/flora/grass/brown,/obj/structure/flora/grass/brown,/turf/unsimulated/floor/frozenground,/area/polarplanet/street)
"T" = (/obj/structure/flora/grass/brown,/obj/structure/flora/grass/brown,/obj/structure/snow,/turf/unsimulated/floor/frozenground,/area/polarplanet/street)
"U" = (/obj/structure/flora/grass/brown,/obj/structure/flora/grass/green,/turf/unsimulated/floor/frozenground,/area/polarplanet/street)
"X" = (/obj/structure/flora/grass/brown,/obj/structure/snow,/turf/unsimulated/floor/frozenground,/area/polarplanet/street)
"Y" = (/obj/structure/flora/grass/green,/obj/structure/snow,/turf/unsimulated/floor/frozenground,/area/polarplanet/street)
"Z" = (/obj/structure/flora/tree/pine,/obj/structure/flora/grass/brown,/obj/structure/flora/grass/green,/turf/unsimulated/floor/frozenground,/area/polarplanet/street)

(1,1,1) = {"
aaaaaaaaaaaaaaaaaaaaaaaaaaaaaaaaaaaaaaaaaaaaaaaaaaaaaaaaaaaaaaaaaaaaaaaaaaaaaaaaaaaoasaaaaaaaFFFFFFFFFFFFFFFFFFFFFFFFFFFaaaaaaaaaaaaaaaaaaaaaaaaaaaaaa
aaaaaaaaaaaaaaaaaaaaaaaaaaaaaaaaaaaaaaaaaaaaaaaaaaaaaaaaaaaaaaaaaaaaaaaaaaaaaaaaaaaaaasaaFdFFFFFFFFFFdFFFdXFXFXDnFPkdFFFFaaaaaaaaaaBaaaaaaaaaaaaaaaaaa
aaaaaaaaaaaaaaaaaaaaaaaaaaaaaaaaaaaaaaaaaaaaaaaaaaaaaaaaaaaaaaaaaaaaaaaaaaaaaaFFFFaaaagkFFFFFFPFFFFFFFXXXFFFFPPasFFFFFFywaaaaaaaaaaBaaaaaaaaaaaaaaaaaa
aaaaaaaaaaaaaaaaaaaaaaaaaaaaaaasaaaaaaaaaaaaFFFFFFFFFaaFFFFFFFFFaaaaaaaaaaaaaaFFFFaaaaaFFFFFFFFFPFFXFXFFFFFFPFFaaaFFFaaFFaaaaaaaaaaBaaaaaaaaaaaaaaaaaa
aaaaaaaaaaaaaaaaaaaaaaaaaaaaaoasaaaaaaaFFFFFFFFFFFFFFFFFFFFFFFFFFFaaaaaaaaaaaanFPkaaaaFXPXFXdXFXXFFPFFFdFFaPFFFaosFFFsaXFFFaaaaaaaaBaaaaaaaaaaaaaaaaaa
aaaaaaaaaaaaaaaaaaaaaaaaaaaaaaaasaaFdFFFFFFFFFFdFFFdXFXFXDnFPkdFFFFaaaaaaaaaaasFFFaaaaFFFPFFFPFFdFFFFFPFFFaaaaaXFTXasasXFFFoaaaaaaaBaaaaaaaaaaaaaaaaaa
aaaaaaaaaaaaaaaaaaaaaaaaaaaaaaaagkFFFFFFPFFFFFFFXXXFFFFPPasFFFFFFywaaaaaaaaaaaaaFFaaaaFFFXPFFFFFFFsFFFasaIksaaFFFPFasaoaFFFFaaaaaaaBaaaaaaaaaaaaaaaaaa
aaaaaaaaaaaaaaaaaaaaaaaaaaaaaaaaaFFFFFFFFFPFFXFXFFFFFFPFFaaaFFFaaFFaaaaFFaaaaaosFFaaadFFFFFPXsFnFFaaFFaadFPaFoFFFFXlFFFFFFFFaaaaaaaBaaaaaaaaaaaaaaaaaa
aaaaaaaaaaaaaaaaaaaaaaaaaaaaaaaaFXPXFXdXFXXFFPFFFdFFaPFFFaosFFFsaXFFFaaaFaaaaaFTXaaaaFFPFdXFFFFFsaaaFFoaFPFaakXFXFFFFFFFFFFFaaaaaaaBaaaaaaaaaaaaaaaaaa
aaaaaaaaaaaaaaaaaaaaaaaaaaaaaaaaFFFPFFFPFFdFFFFFPFFFaaaaaXFTXasasXFFFoaaFaaaaFFPFaaaFFFFFFFdPFFasaaoaasaXsXaUaFPFFFFFFFFFFFFaaaaaaaBaaaaaaaaaaaaaaaaaa
aaaaaaaaaaaaaaaaaaaaaaaaaaaaaaaaFFFXPFFFFFFFsFFFasaIksaaFFFPFasaoaFFFFaaFFaaFFFFXlaaFFFFPFFFFXFFaUaaksFFFasgkaPFFXFFFFFFFdFFaaaaaaaBaaaaaaaaaaaaaaaaaa
aaaaaaaaaaaaaaaaaaaaaaaaaaaaaaadFFFFFPXsFnFFaaFFaadFPaFoFFFFXlFFFFFFFFaaFFaFFaXFFFaFFFFFFFFFFFUaaoaaaaaFFaaasskaFFFFFFFFFFFFFaaaaaaBaaaaaaaaaaaaaaaaaa
aaaaaaaaaaaaaaaaaaaaaaaaaaaaaaaFFPFdXFFFFFsaaaFFoaFPFaakXFXFFFFFFFFFFFaaFFaFaaFFFFaFFFFFKFFXFaasaaskoaFFaaaakassaaFFFFdFFFFFFaaaaaaBaaaaaaaaaaaaaaaaaa
aaaaaaaaaaaaaaaaaaaaaaaaaaaaaaFFFFFFFdPFFasaaoaasaXsXaUaFPFFFFFFFFFFFFaaFFFFaaFXFFaFFFFFFPPFFaaagaaaUaFFkoakaIaosaFFdFFFFFFFFFaaaaaBaaaaaaaaaaaaaaaaaa
aaaaaaaaaaaaaaaaaaaaaaaaaaaaaaFFFFPFFFFXFFaUaaksFFFasgkaPFFXFFFFFFFdFFaaaFFFFaFFFFaaFFFdFFFkaoaakXFsahUssaUSoaaaaasFFFFaFFFFFFaaaaaBaaaaaaaaaaaaaaaaaa
aaaaaaaaaaaaaaaaaaaaaaaaaaaaaaaaaaaaaaaaaaaaaaaaaaaaaaaaaaaaaaaaaFFFFFFaaFFFFaaaFFaaaFFFFFFaUaaaFFFUsoskUsaksUUaaaaFFFFaFFFFFFFaaaaBaaaaaaaaaaaaaaaaaa
aaaaaaaaaaaaaaaaaasaaaaaaaaaaaaFFFFFFFFFaaFFFFFFFFFaaaaaaaaaaaaaaFFFFFFaaaFFFFsaFFaaaaFFFFFaFkaaaaaaUoaoakakaaosagaFFnFoaaFPdFFaaaaBaaaaaaaaaaaaaaaaaa
aaaaaaaaaaaaaaaaoasaaaaaaaFFFFFFFFFFFFFFFFFFFFFFFFFFFaaaaaaaaaaaaFFFFFFFaaFFFFFasFaaaaaFFFdFFsgakaakPXaaaakaFakakaaXFFFaaPFFFFFFaaaBaaaaaaaaaaaaaaaaaa
aaaaaaaaaaaaaaaaaaasaaFdFFFFFFFFFFdFFFdXFXFXDnFPkdFFFFaaaaaaFFFaaaFFFFFFaaFFFFFaaFaaaaaFFFFFFaasokoaPFsvkokaFPaakkaasaaasFFFFFFFaaaBaaaaaaaaaaaaaaaaaa
aaaaaaaaaaaaaaaaaaagkFFFFFFPFFFFFFFXXXFFFFPPasFFFFFFywaaaaaaFaFFaaFFFFFFFaaFFFagaFaaaaaaFFFaaagaFskaIFaasaaaaFaaaPIFkIasFFFFFFFFdaaBaaaaaaaaaaaaaaaaaa
aaaaaaaaaaaaaaaaaaaaFFFFFFFFFPFFXFXFFFFFFPFFaaaFFFaaFFaaaaaaFaaFaoaaFPdFFaaFFakaaXaaaaaaFFFaaasaFaaasxPPaaosasndFFssaavFPFPPPFPPaaaBaaaaaaaaaaaaaaaaaa
aaaaaaaaaaaaaaaaaaaFXPXFXdXFXXFFPFFFdFFaPFFFaosFFFsaXFFFaaaaaFaFaaaPFFFFFFaaFakkaaaaaaaaaFFoaaaoaaoasaPFskakaFXFFFPaGsaFPXFdFFFFaaaBaaaaaaaaaaaaaaaaaa
aaaaaaaaaaaaaaaaaaaFFFPFFFPFFdFFFFFPFFFaaaaaXFTXasasXFFFoaaaaaFFaasFFFFFFFaaFaaPIFaaaaaaaFFFFFFXFFFFgIFFFaaagaPnFTssskaFFFFFFFFFFaaBaaaaaaaaaaaaaaaaaa
aaaaaaaaaaaaaaaaaaaFFFXPFFFFFFFsFFFasaIksaaFFFPFasaoaFFFFaaaaaFFasFFFFFFFFdaaaaFssaaaaaaaaFFFFFXFFFFskjaakdkaPFPFPaaFaaoFFFFXFFFFaaBaaaaaaaaaaaaaaaaaa
aaaaaaaaaaaaaaaaaadFFFFFPXsFnFFaaFFaadFPaFoFFFFXlFFFFFFFFaaaaFFFaFPFPPPFPPaaaFaaPaaaaaaaaFFFFFFFXXFFdnFkaNFFakaaaaoaaaaaadFFFXFFdaaBaaaaaaaaaaaaaaaaaa
aaaaaaaaaaaaaaaaaaaaaaaaaaaaaaaaaaaaaaaaaaaaaaaaaaaaaaaaaaaaaFFFaFPXFdFFFFaaFFFTssaaaaaaaFFFFFFFdFXFFFFZaFFFssoFaaFaaaFaaFFFFFaaaaaBaaaaaaaaaaaaaaaaaa
aaaaaaaaaaaaasaaaaaaaaaaaaFFFFFFFFFaaFFFFFFFFFaaaaaaaaaoaaaaFFFaaFFFFFFFFFFaaFFYaaaaaaaaFFFFFFFFFFXXFFFkkkPaoassaaaaaFFFFFFFFFFaaaaBaaaaaaaaaaaaaaaaaa
aaaaaaaaaaaoasaaaaaaaFFFFFFFFFFFFFFFFFFFFFFFFFFFaaaaaaaaaFFFFFaaaoFFFFXFFFFaaFaaoaaaaaaFFFFFFFFFFFFnFFUkasUaasskaaaoaFFAFFFFFFFFaaaBaaaaaaaaaaaaaaaaaa
aaaaaaaaaaaaaasaaFdFFFFFFFFFFdFFFdXFXFXDnFPkdFFFFaaaaaaaaFFFFFaaaaadFFFXFFdaaaFaaaaaaaaFFFFFFFFFFFFFoaaasaaoaasaaaFaaFFFFFFFFFFFFaaBaaaaaaaaaaaaaaaaaa
aaaaaaaaaaaaaagkFFFFFFPFFFFFFFXXXFFFFPPasFFFFFFywaaaaaFFaFFFFFaaaaaFFFFFaaaaaFFaaaaaaaaaFFFFFFFFFFdFkssFvaaUasaaoaaaaFFFFFFrFFFFdaaBaaaaaaaaaaaaaaaaaa
aaaaaaaaaaaaaaaFFFFFFFFFPFFXFXFFFFFFPFFaaaFFFaaFFaoaaaFFaFFFaFFaaFFFFFFFFaaaFFFaaoaaaaaaaFFFFdFFFFFFaasaakaUaaaPFFFFdFFFFFrFFFFFFaaBaaaaaaaaaaaaaaaaaa
aaaaaaaaaaaaaaFXPXFXdXFXXFFPFFFdFFaPFFFaosFFFsaXFFFaaaFFFFFFaaFFaAFFFFFFFFaaFaFaFaaaaaaaaaFFFFFFYFnaFaaaasFksoFFFFFFFFFFFrFFFFFFaaaBaaaaaaaaaaaaaaaaaa
aaaaaaaaaaaaaaFFFPFFFPFFdFFFFFPFFFaaaaaXFTXasasXFFFoaaFFFFFaaaFFaFFFFFFFFFFaaadaaaaaaaaaaaaaFFFFFFFaaaFsaaasksaFFFFFFFFFrFFFFFFaaaaBBBBBBBBBBBBBBBBBBB
aaaaaaaaaaaaaaFFFXPFFFFFFFsFFFasaIksaaFFFPFasaoaFFFFaaFFFFaFaaFFFFFFFFFFFFdaFFFFaaaaaaaaaaaaFdFsaaFoFaaZaasavaFFFPFFFFFrrFFFFFaaaaaaaaaaaaaaaaaaaaaaaa
aaaaaaaaaaaaadFFFFFPXsFnFFaaFFaadFPaFoFFFFXlFFFFFFFFaaaFFaFFFaFFFFFFFrFFFFFaaaFFFaaaaaaaaaaFXaaaaaFaaFkasaakaaaaaakFFFFFFFFFFFaaaaaaaaaaaaaaaaaaFFFFFF
aaaaaaaaaaaaaFFPFdXFFFFFsaaaFFoaFPFaakXFXFFFFFFFFFFFaaaFFaaFFaFFFFFFFrFFFFaaFFFFFFaaaaaFFXaFFfFaoaFaasaaadaakaaaoaaFFFFFFFFFFFaaaaaaFaaaaaaFaaFFFFFFFF
aaaaaaaaaaaaFFFFFFFdPFFasaaoaasaXsXaUaFPFFFFFFFFFFFFaaaFoFFFFdaFFFFrrFFFFaaaFFFPFFaassFFFaoakssaFsaasavaaaaaaasaaaoFFFFFFFFFFaaaaaaaFoaaaaFFFaFXFXDnFP
aaaaaaaaaaaaFFFFPFFFFXFFaUaaksFFFasgkaPFFXFFFFFFFdFFaaaFaFFFPaaFFFFFFFFFaaaaFaaakFaFFFssaaaaassaaaagskaaaaaakaagFFFFFFFFFFFFFaaaaaaaFFaaaFFFFaFFPPasFF
aaaaaaaaaaaFFFFFFFFFFFUaaoaaaaaFFaaasskaFFFFFFFFFFFFFaaFFFFaFaaFFFrFFFFFaaaFFaoaaaaFFFaaaakaaaFassaakFFaaaoaaoaaXFFFPFFFFFFFaaaaaaaaFFaaaFFFFaFPFFaaaF
aaaaaaaaaaaFFFFFKFFXFaasaaskoaFFaaaakassaaFFFFdFFFFFFaaFFFFaFFaFFFFFFFFFaaaFFaaaoFFFFFaaoaksdsasossvFaaagaFFFkaasaaFFFFFFFFaaaaaaaaaFFaaaFFFaaPFFFaosF
aaaaaaaaaaaFFFFFFPPFFaaagaaaUaFFkoakaIaosaFFdFFFFFFFFFaaFFFaFFaFFFFFFFFaaaaFFaFFFFFFFFoaaaaaaaFasakaaFFaaaXFFaaoasaFFFFFFFaaaaaaaaaaFFaaaaFFaaaaaaXFTX
aaaaaaaaaaaaFFFdFFFkaoaakXFsahUssaUSoaaaaasFFFFaFFFFFFaaaFFaFdaFFFQFFFFaaaaFFaXFFFFFFFwPFFFoaaaSaaaaaaaaaFFFXaaaasoFFFPFFaaaaaaaaaaaFFaaaaFFaasaaFFFPF
aaaaaaaaaaaaaFFFFFFaUaaaFFFUsoskUsaksUUaaaaFFFFaFFFFFFFaaaaoaaaFFQQFFFaaaaaFFasaaFFFFFPFFFFFXFXXFXFXFFdaaFFaaFXFlFFFFFPPFaaaaaaaaaaaFFFaaaFFFaaFoFFFFX
aaaaaaaaaaaaaaFFFFFaFkaaaaaaUoaoakakaaosagaFFnFoaaFPdFFaaaaaaaaFFFFFFaaaaaaaFaasaFaFFFFFFFFlFFFFFFdFFdXaoaaFaFFFFFFFFdFFFaaaaaaaaaaaFFFaaaFFFaaakXFXFF
aaaaaaaaaaaaaaaFFFdFFsgakaakPXaaaakaFakakaaXFFFaaPFFFFFFaaaaFaaFFFFFaaaaaaaaaaasoFaaFdFFFFFFFFFFFFFFFFFFFFsoaXFFXFFFFFFFaaaaaaaaaaaaFFFFaaaFFaaUaFPFFF
aaaaaaaaaaaaaaaFFFFFFaasokoaPFsvkokaFPaakkaasaaasFFFFFFFaaaaFFFFFFFaaaaaaaaaaalFFaaaFFFFFFFFFFFdFFFFFFFFFFaaaaaaFFXFXaaaaaaaaaaaaaaaFFFFaaaFFagkaPFFXF
aaaaaaaaaaaaaaaaFFFaaagaFskaIFaasaaaaFaaaPIFkIasFFFFFFFFdaaaFdFFFPFaaaaaaaaaaaFFFFaaaaFFFdFFFFFFFFFFFFaaaaaaaaaoFFFFFaoaaaaaaaaaaaaaFFFFFaaaFFasskaFFF
aaaaaaaaaaaaaaaaFFFaaasaFaaasxPPaaosasndFFssaavFPFPPPFPPaaaaFFFFFFFaaaaaaaaaaaXFFFaaaaaaaFFFFFFFFFaaoaaaaaaaaaaaaaaaaaaaaaaaaaaaaaaaFPdFFaaaaFakassaaF
aaaaaaaaaaaaaaaaaFFoaaaoaaoasaPFskakaFXFFFPaGsaFPXFdFFFFaaaaFaFFFFaaaaaaaaaaaaFFXFXaaaaaaaaaaaaaaFFFdFFsgakaakPXaaaakaFakakaaXFFFaaPFFFFFFaaaFkaIaosaF
aaaaaaaaaaaaaaaaaFFFFFFXFFFFgIFFFaaagaPnFTssskaFFFFFFFFFFaaaaaFFFaaaaaaaaaaaaaFFFFFaoaaaaaaaaaaaaFFFFFFaasokoaPFsvkokaFPaakkaasaaasFFFFFFFaaaFSoaaaaas
aaaaaaaaaaaaaaaaaaFFFFFXFFFFskjaakdkaPFPFPaaFaaoFFFFXFFFFaaaFFFFaaaaaaaaaaaaaaaaaaaaaaaaaaaaaaaaaaFFFaaagaFskaIFaasaaaaFaaaPIFkIasFFFFFFFFdaFFksUUaaaa
aaaaaaaaaaaaaaaaaFFFFFFFXXFFdnFkaNFFakaaaaoaaaaaadFFFXFFdaaFFFFFaaaaaaaaaaaaaaaaoaaaaaFFaaasaaaaaaFFFaaasaFaaasxPPaaosasndFFssaavFPFPPPFPPaaFakaaosaga
aaaaaaaaaaaaaaaaaFFFFFFFdFXFFFFZaFFFssoFaaFaaaFaaFFFFFaaaaaFFFFFaaFFFFFKFFXFaasaaskoaFFaaaakaaaaaaaFFoaaaoaaoasaPFskakaFXFFFPaGsaFPXFdFFFFaaFaaFakakaa
aaaaaaaaaaaaaaaaFFFFFFFFFFXXFFFkkkPaoassaaaaaFFFFFFFFFFaaaaFFFFaaaFFFFFFPPFFaaagaaaUaFFkoakaaaaaaaaFFFFFFXFFFFgIFFFaaagaPnFTssskaFFFFFFFFFFFFFaFPaakka
aaaaaaaaaaaaaaaFFFFFFFFFFFFnFFUkasUaasskaaaoaFFAFFFFFFFFaaaFFFFaaaaFFFdFFFkaoaakXFsahUssaUSoaaaaaaaaFFFFFXFFFFskjaakdkaPFPFPaaFaaoFFFFXFFFFaaFaaFaaaPI
aaaaaaaaaaaaaaaFFFFFFFFFFFFFoaaasaaoaasaaaFaaFFFFFFFFFFFFaaaFFFFaaaaFFFFFFaUaaaFFFUsoskUsaksaaaaaaaFFFFFFFXXFFdnFkaNFFakaaaaoaaaaaadFFFXFFdaaFsasndFFs
aaaaaaaaaaaaaaaaFFFFFFFFFFdFkssFvaaUasaaoaaaaFFFFrrFFFFFdaaaFFrFFaaaaFFFFFaFkaaaaaaUoaoakakaaaaaaaaFFFFFFFdFXFFFFZaFFFssoFaaFaaaFaaFFFFFaaaaFFkaFXFFFP
aaaaaaaaaaaaaaaaaFFFFdFFFFFFaasaakaUaaaPFFFFdFFFrrFFFFFFFaaaFrrFFFaaaaFFFdFFsgakaakPXaaaakaFaaaaaaFFFFFFFFFFXXFFFkkkPaoassaaaaaFFFFFFFFFFaaFFaagaPnFTs
aaaaaaaaaaaaaaaaaaFFFFFFYFnaFaaaasFksoFFFFFFFFFFrFFFFFFFaaaFFrFFFFaaaaFFFFFFaasokoaPFsvkokaFaaaaaaaaaaaaaaaaaaaaaaaaaaaaaaaaaaaaaaaaaFFFFaaFFaaaPFPFPa
aaaaaaaaaaaaaaaaaaaaFFFFFFFaaaFsaaasksaFFFFFFFFFFFFFFFFaaaaFFrFFFFFFaaaFFFaaagaFskaIFaasaaaaaaaaasaaaaaaaaaaaaFFFFFFFFFaaFFFFFFFFFaaaaFFFFFFFaaakaaaao
aaaaaaaaaaaaaaaaaaaaFdFsaaFoFaaZaasavaFFFPFFFFFrFFFFFFaaaaFFFFFFFFFFFaaFFFaaasaFaaasxPPaaosaaaaoasaaaaaaaFFFFFFFFFFFFFFFFFFFFFFFFFFFaaaFFFaFFaaasoFaaF
aaaaaaaaaaaaaaaaaaaFXaaaaaFaaFkasaakaaaaaakFFFFrFFFFFFaaaaFFFFFFFFFFFaaaFFoaaaoaaoasaPFskakaaaaaaasaaFdFFFFFFFFFFdFFFdXFXFXDnFPkdFFFFaaFFFFFFaaaassaaa
aaaaaaaaaaaaaaaFFXaFFfFaoaFaasaaadaakaaaoaaFFFFFFFFFFFaaaFFFFaaaaaaaFaaaFFFFFFXFFFFgIFFFaaagaaaaaagkFFFFFFPFFFFFFFXXXFFFFPPasFFFFFFywaaFaFFFFaaasskaaa
aaaaaaaaaaaassFFFaoakssaFsaasavaaaaaaasaaaoFFFFFFFFFFaaaFFFFFaaaaaaaaaaaaFFFFFXFFFFskjaakdkaaaaaaaaFFFFFFFFFPFFXFXFFFFFFPFFaaaFFFaaFFaaaaFFFaaaaasaaaF
aaaaaaaaaaaFFFssaaaaassaaaagskaaaaaakaagFFFFFFFFFFFFFaaFFFFFaaaaaaaaaaaaFFFFFFFXXFFdnFkaNFFaaaaaaaFXPXFXdXFXXFFPFFFdFFaPFFFaosFFFsaXFFFaaaaaaaaasaaoaa
aaaaaaaaaaaFFFaaaakaaaFassaakFFaaaoaaoaaXFFFPFFFFFFFaaFFFFFFaaoaaaaaaaaaFFFFFFFdFXFFFFZaFFFsaaaaaaFFFPFFFPFFdFFFFFPFFFaaaaaXFTXasasXFFFoaaaaaaaaaaPFFF
aaaaaaaaaaFFFFaaoaksdsasossvFaaagaFFFkaasaaFFFFFFFFaaaFFFFFaaaFaaaaaaaaFFFFFFFFFFXXFFFkkkPaoaaaaaaFFFXPFFFFFFFsFFFasaIksaaFFFPFasaoaFFFFaaaaaaaaoFFFFF
aaaaaaaaaaFFFFoaaaaaaaFasakaaFFaaaXFFaaoasaFFFFFFFaaaFFFFFaaaaaaaaaaaaFFFFFFFFFFFFnFFUkasUaaaaaaadFFFFFPXsFnFFaaFFaadFPaFoFFFFXlFFFFFFFFaaaaaaaasaFFFF
aaaaaaaaaaFFFFwPFFFoaaaSaaaaaaaaaFFFXaaaasoFFFPFFaaaaFFFFFaaaaaoaaaaaaFFFFFFFFFFFFFoaaasaaoaaFaaaFFPFdXFFFFFsaaaFFoaFPFaakXFXFFFFFFFFFFFaaaaaaaaaFFFPF
aaaaaaaaaaFFFFPFFFFFXFXXFXFXFFdaaFFaaFXFlFFFFFPPFaaaaFFFFFaaaaFaaaaaaaaFFFFFFFFFFdFkssFvaaUaaFaaFFFFFFFdPFFasaaoaasaXsXaUaFPFFFFFFFFFFFFaaaaaaaaaaaaak
aaaaaaaaaaaFFFFFFFFlFFFFFFdFFdXaoaaFaFFFFFFFFdFFFaaaFFFFFaaaoaaaaaaaaaaaFFFaaaaaaaaaaaaaaaaaaaaaaaaaaaaaaaaaaaaaaaaaaaaaaaaaaXFFFFFFFdFFaaaaaaaaaaaoaa
aaaaaaaaaaaaFdFFFFFFFFFFFFFFFFFFFFsoaXFFXFFFFFFFaaaFFFFFaaaaFFFFdaaaaaaaaFFaaasaaaaaaaaaaaaFFFFFFFFFaaFFFFFFFFFaaaaaaaaaaaaaaFFFFFFFFFFFFaaaaaaaasaaao
aaaaaaaaaaaaFFFFFFFFFFFdFFFFFFFFFFaaaaaaFFXFXaaaaaaFFFaaaaaaFFFFFaaaaaaaaaaaoasaaaaaaaFFFFFFFFFFFFFFFFFFFFFFFFFFFaaaaaaaaaaaaaFFFFdFFFFFFaaaaaaaaagFFF
aaaaaaaaaaaaaaFFFdFFFFFFFFFFFFaaaaaaaaaoFFFFFaoaaaaaaaaaaaaaFFFFFaaaaaaaaaaaaaasaaFdFFFFFFFFFFdFFFdXFXFXDnFPkdFFFFaaaaaaaaaaaaFFdFFFFFFFFFaaaaaaoaaXFF
aaaaaaaaaaaaaaaaaFFFFFFFFFaaoaaaaaaaaaaaaaaaaaaaaaaaaaaaaaaaFPFFFaaaaaaaaaFaaaagkFFFFFFPFFFFFFFXXXFFFFPPasFFFFFFywaaaaaaaaaaaasFFFFaFFFFFFaaaaaakaasaa
aaaaaaaaaaaaaaaaaaaaaaaaaaaaaaaaaaaaaaaFXaaaaaFaaFkasaakaaaaaakFFaaaaaFFXaFaaaaaFFFFFFFFFPFFXFXFFFFFFPFFaaaFFFaaFFaaaaaaaaaaaaaFFFFaFFFFFFFaaaaaaaoasa
aaaaaaaaaaaaaaaaaaaaaaaaaaaaaaaaaaaFFXaFFfFaoaFaasaaadaakaaaoaaFFaassFFFaoaaaaaFXPXFXdXFXXFFPFFFdFFaPFFFaosFFFsaXFFFaaaaaaaaagaFFnFoaaFPdFFaaaaaaaaaso
aaaaaaaaaaaaaaaaaaaaaaaaaaaaaaaassFFFaoakssaFsaasavaaaaaaasaaaoFFaFFFssaaaaaaaaFFFPFFFPFFdFFFFFPFFFaaaaaXFTXasasXFFFoaaaaaaaaaaXFFFaaPFFFFFFaaaaFXFlFF
aaaaaaaaaaaaaaaaaaaaaaaaaaaaaaaFFFssaaaaassaaaagskaaaaaakaagFFFFFaFFFaaaakaaaaaFFFXPFFFFFFFsFFFasaIksaaFFFPFasaoaFFFFaaaaaaaakaasaaasFFFFFFFaaaaFFFFFF
aaaaaaaaaaaaaaaaaaaaaaaaaaaaaaaFFFaaaakaaaFassaakFFaaaoaaoaaXFFFPFFFFaaoaksaaadFFFFFPXsFnFFaaFFaadFPaFoFFFFXlFFFFFFFFaaaaaaaaPIFkIasFFFFFFFFdaaaXFFXFF
aaaaaaaaaaaaaaaaaaaaaaaaaaaaaaFFFFaaoaksdsasossvFaaagaFFFkaasaaFFFFFFoaaaaaaaaFFPFdXFFFFFsaaaFFoaFPFaakXFXFFFFFFFFFFFaaaaaaaaFssaavFPFPPPFPPaaaaaaaFFX
aaaaaaaaaaaaaaaaaaaaaaaaaaaaaaFFFFoaaaaaaaFasakaaFFaaaXFFaaoasaFFFFFFwPFFFoaaFFFFFFFdPFFasaaoaasaXsXaUaFPFFFFFFFFFFFFaaaaaaaaFPaGsaFPXFdFFFFaaaaaaoFFF
aaaaaaaaaaaaaaaaaaaaaaaaaaaaaaaaaaaaaaaaaaaaaaaaaaaaaaaaaaaaaaaaaFFFFPFFFFFaaFFFFPFFFFXFFaUaaksFFFasgkaPFFXFFFFFFFdFFaaaaaaaaTssskaFFFFFFFFFFaaaaaaaaa
aaaaaaaaaaaaaaaaaaaaasaaaaaaaaaaaaFFFFFFFFFaaFFFFFFFFFaaaaaaaaaaaaFFFFFFFFlaFFFFFFFFFFFUaaoaaaaaFFaaasskaFFFFFFFFFFFFFaaaaaaaPaaFaaoFFFFXFFFFaaaaaaaaa
aaaaaaaaaaaaaaaaaaaoasaaaaaaaFFFFFFFFFFFFFFFFFFFFFFFFFFFaaaaaaaaaaaaaaaaaaaaaaaaaaaaaaaaaaaaaaaaaaaaaaaaaaaaaaaaaFFFFFaaaaaaaaoaaaaaadFFFXFFdaaaaaaaaa
aaaaaaaaaaaaaaaaaaaaaasaaFdFFFFFFFFFFdFFFdXFXFXDnFPkdFFFFaaaaaaaaasaaaaaaaaaaaaaFFFFFFFFFFFFFFFFFFFaaaaFFFFFaaaaaFFFFFFaaaaaaaFaaaFaaFFFFFaaaaaaaaaaaa
aaaaaaaaaaaaaaaaaaaaaagkFFFFFFPFFFFFFFXXXFFFFPPasFFFFaaaaaaaaaaaaaaaaaaaaaaaaaaFFFFFFFFFFFFFFFFFFFFFaFFFFFFFaaaaaFFFFFFaaaaaaaaaaFFFFFFFFFFaaaaaaaaaaa
aaaaaaaaaaaaaaaaaaaaaaaaaaaaaaaaaaaaaaaaaaaaaaaaaaaaaaaaaaaaaaaaaaaaaaaaaaaaaaaaaaaaaaaaaaFFFFFFFFFFaFFFFFFFaaaaaFFFFFFFaaaaaaaoaFFAFFFFFFFFaaaaaaaaaa
aaaaaaaaaaaaaaaaasaaaaaaaaaaaaFFFFFFFFFaaFFFFFFFFFaaaaaaaaaaaaaaaaaaFFFFFFFFFaaFFFFFFFFFaaaaaFFFFFFFFFFFaFFaFaaaaaaFPdFFaaaaaaFaaFFFFFFFFFFFFaaaaaaaaa
aaaaaaaaaaaaaaaoasaaaaaaaFFFFFFFFFFFFFFFFFFFFFFFFFFFaaaaaaaaaaaaFFFFFFFFFFFFFFFFFFFFFFFFFFaaaaFFFFFFFFFaaFFFFaaaaaPFFFFFFaaaaaaaaFFFFFFFFFFFdaaaaaaaaa
aaaaaaaaaaaaaaaaaasaaFdFFFFFFFFFFdFFFdXFXFXDnFPkdFFFFaaaaaaaaaaaFFFFFFFdFFFdXFXFXDnFPkdFFFFaaaFFFFFFFFaFaaFFFaaaasFFFFFFFaaaaFFFdFFFFFFFFFFFFaaaaaaaaa
aaaaaaaaaaaaaaaaaagkFFFFFFPFFFFFFFXXXFFFFPPasFFFFFFywaaaaaaaaaaaPFFFFFFFXXXFFFFPPasFFFFFFywaaaaFFFFaFFaFoaaFFFaaaFFFFFFFFdaaaFFFFFFFFFFFFFFFaaaaaaaaaa
aaaaaaaaaaaaaaaaaaaFFFFFFFFFPFFXFXFFFFFFPFFaaaFFFaaFFaaaaaaaaaaaFFPFFXFXFFFFFFPFFaaaFFFaaFFaaaaFFFFaFaaFFaaFFFaaaPFPPPFPPaaaFFFFFFFFFFFFFFFaaaaaaaaaaa
aaaaaaaaaaaaaaaaaaFXPXFXdXFXXFFPFFFdFFaPFFFaosFFFsaXFFFaaaaaaaaaaaaaaaaaaaaaaaaaaaaaaaaaaXFFFaaFFFFFFaaaFaaFFFFaaPXFdFFFFaaaFPFFFFFrrQFFFFaaaaaaaaaaaa
aaaaaaaaaaaaaaaaaaFFFPFFFPFFdFFFFFPFFFaaaaaXFTXasasXFFFoaaaaaaaaaFFFFFFFFFaaaaaaaaaaaaaasXFFFoaFFFFFaaaaaaaFFFFaaFFFFFFFFFaFFakFFFFQQrFFFFaaaaaaaaaaaa
aaaaaaaaaaaaaaaaaaFFFXPFFFFFFFsFFFasaIksaaFFFPFasaoaFFFFaaaaaaaaFFFFFFFFFFFFaaaaaaaaaaaaoaFFFFaaFFFFaaaaFaaaFFFaaFFFFXFFFFaFFaaFFFFFFFFFFFaaaaaaaaaaaa
aaaaaaaaaaaaaaaaadFFFFFPXsFnFFaaFFaadFPaFoFFFFXlFFFFFFFFaaaaaaaaXFXDnFPkdFFFFaaaaaaaaaaaFFFFFFaaFFFFFaaaFaaaFFFaaadFFFXFFdaFFaoFFFFFFFFFFaaaaaaaaaaaaa
aaaaaaaaaaaaaaaaaFFPFdXFFFFFsaaaFFoaFPFaakXFXFFFFFFFFFFFaaaaaaaaFPPasFFFFFFywaaaaaaaaaaaFFFFFFaaFFFFFaaaFFaaFFFFaaFFFFFaaaaFFFFFFFFFFFFFFaaaaaaaaaaaaa
aaaaaaaaaaaaaaaaFFFFFFFdPFFasaaoaasaXsXaUaFPFFFFFFFFFFFFaaaoaaaaPFFaaaFFFaaFFaaaaaaaaaaaFFFFFFaaaFFFFFaFFFaaFFFFaaFFFFFFaaaFFFFFPFFFFFFFaaaaaaaaaaaaaa
aaaaaaaaaaaaaaaaFFFFPFFFFXFFaUaaksFFFasgkaPFFXFFFFFFFdFFaaaaaaaaFFFaosFFFsaXFFFaaaaaaaaaFFFdFFaaaFFFFFaFFFFaaFFFaaFFFFFFFaaaFaaFFFFFFFFaaaaaaaaaaaaaaa
aaaaaaaaaaaaaaaFFFFFFFFFFFUaaoaaaaaFFaaasskaFFFFFFFFFFFFFaaaaaaaaaaXFTXasasXFFFoaaaaaaaaFFFFFFFaaFFFFFaFFFFaaFFFaFFFFFFFFFaFFsaFFFFFFFaaaaaaaaaaaaaaaa
aaaaaaaaaaaaaaaFFFFFKFFXFaasaaskoaFFaaaakassaaFFFFdFFFFFFaaaaaaaaaFFFPFasaoaFFFFaaaaaaaadFFFFFFaaaFFFFaFFFFFaaFFaFFFFFFFFdaFasoFFFPFFaaaaaaaaaaaaaaaaa
aaaaaaaaaaaaaaaFFFFFFPPFFaaagaaaUaFFkoakaIaosaFFdFFFFFFFFFaaaaaaFoFFFFXlFFFFFFFFaaaaaaaaFFFFFFFFaaaFFFaFPdFFaaaFaFFFFFFFFFaFaFFFFFPPFaaaaaaaaaaaaaaaaa
aaaaaaaaaaaaaaaaFFFdFFFkaoaakXFsahUssaUSoaaaaasFFFFaFFFFFFaaaaaaakXFXFFFFFFFFFFFaaaaaaaaFaFFFFFFaaaFFFFFFFFFFaaFFFFFFFFFFaaFaFFFFdFFFaaaaaaaaaaaaaaaaa
aaaaaaaaaaaaaaaaaFFFFFFaUaaaFFFUsoskUsaksUUaaaaFFFFaFFFFFFFaaaaaUaFPFFFFFFFFFFFFaaaaaaaaFaFFFFFFFaaFFFFFFFFFFaaFFFFFFFFFaaaFFFFFFFFFaaaaaaaaaaaaaaaaaa
aaaaaaaaaaaaaaaaaaFFFFFaFkaaaaaaUoaoakakaaosagaFFnFoaaFPdFFaaoaakaPFFXFFFFFFFdFFaaaaaaaaFoaaFPdFFaaaFFFFFFFFFdaFFFFFFFFaaaaaFFXFXaaaaaaaaaaaaaaaaaaaaa
aaaaaaaaaaaaaaaaaaaFFFdFFsgakaakPXaaaakaFakakaaXFFFaaPFFFFFFaaaasskaFFFFFFFFFFFFFaaaaaaaFaaPFFFFFFaaFFFPPPFPPaaaaFFFFFFaaaaaaFFFFaoaaaaaaaaaaaaaaaaaaa
aaaaaaaaaaaaaaaaaaaFFFFFFaasokoaPFsvkokaFPaakkaasaaasFFFFFFFaaaakassaaFFFFdFFFFFFaaaaaaaaasFFFFFFFaaFFFFdFFFFaaaaFFFFFFaaaaaaaaaaaaaaaaaaaaaaaaaaaaaaa
aaaaaaaaaaaaaaaaaaaaFFFaaagaFskaIFaasaaaaFaaaPIFkIasFFFFFFFFdaaaaIaosaFFdFFFFFFFFFaaaaaaasFFFFFFFFdaaFFFFFFFFFaaaaFFFFaaaaaaaaaaaaaaaaaaaaaaaaaaaaaaaa
aaaaaaaaaaaaaaaaaaaaFFFaaasaFaaasxPPaaosasndFFssaavFPFPPPFPPaaaaoaaaaasFFFFaFFFFFFaaaaaavFPFPPPFPPaaaFaFFXFFFFaaaaFFFFaaaaaaaaaaaaaaaaaaaaaaaaaaaaaaaa
aaaaaaaaaaaaaaaaaaaaaFFoaaaoaaoasaPFskakaFXFFFPaGsaFPXFdFFFFaaaasUUaaaaFFFFaFFFFFFFaaaaaaFPXFdFFFFaaaFaFFFXFFdaaaFFFFaaaaaaaaaaaaaaaaaaaaaaaaaaaaaaaaa
aaaaaaaaaaaaaaaaaaaaaFFFFFFXFFFFgIFFFaaagaPnFTssskaFFFFFFFFFFaaaaaosagaFFnFoaaFPdFFaaaaaaFFFFFFFFFFaaFaFFFFaaaaaFFFFaaaaaaaaaaaaaaaaaaaaaaaaaaaaaaaaaa
aaaaaaaaaaaaaaaaaaaaaaFFFFFXFFFFskjaakdkaPFPFPaaFaaoFFFFXFFFFaaaFakakaaXFFFaaPFFFFFFaaaaaoFFFFXFFFFaFFaFFFFFaaaFFFFFaaaaaaaaaaaaaaaaaaaaaaaaaaaaaaaaaa
aaaaaaaaaaaaaaaaaaaaaFFFFFFFXXFFdnFkaNFFakaaaaoaaaaaadFFFXFFdaaaFPaakkaasaaasFFFFFFFaaaaaaadFFFXFFdaFFaFFFFFFaaaaFFaaaaaaaaaaaaaaaaaaaaaaaaaaaaaaaaaaa
aaaaaaaaaaaaaaaaaaaaaFFFFFFFdFXFFFFZaFFFssoFaaFaaaFaaFFFFFaaaaaaaFaaaPIFkIasFFFFFFFFdaaaFaaFFFFFaaaaFFaFFFFFFFaaaFaaaaaaaaaaaaaaaaaaaaaaaaaaaaaaaaaaaa
aaaaaaaaaaaaaaaaaaaaFFFFFFFFFFXXFFFkkkPaoassaaaaaFFFFFFFFFFaaaaaasndFFssaavFPFPPPFPPaaaaFFFFFFFFFaaaFFaFFFFFFdaaaaaaaaaaaaaaaaaaaaaaaaaaaaaaaaaaaaaaaa
aaaaaaaaaaaaaaaaaaaFFFFFFFFFFFFnFFUkasUaasskaaaoaFFAFFFFFFFFaaaaaFXFFFPaGsaFPXFdFFFFaaaaFAFFFFFFFFaaFaaFFFFFFFaaaaaaaaaaaaaaaaaaaaaaaaaaaaaaaaaaaaaaaa
aaaaaaaaaaaaaaaaaaaFFFFFFFFFFFFFoaaasaaoaasaaaFaaFFFFFFFFFFFFaaagaPnFTssskaFFFFFFFFFFaaaFFFFFFFFFFFaaaaFFFFFFaaaaaaaaaaaaaaaaaaaaaaaaaaaaaaaaaaaaaaaaa
aaaaaaaaaaaaaaaaaaaaFFFFFFFFFFdFkssFvaaUasaaoaaaaFFFFFFFFFFFdaaaaPFPFPaaFaaoFFFFXFFFFaaaFFFFFFFFFFdaaaaFFFFFaaaaaaaaaaaaaaaaaaaaaaaaaaaaaaaaaaaaaaaaaa
aaaaaaaaaaaaaaaaaaaaaFFFFdFFFFFFaasaakaUaaaPFFFFdFFFFFFFFFFFFaaaakaaaaoaaaaaadFFFXFFdaaaFFFFFFFFFFFaaaaFFFFaaaaaaaaaaaaaaaaaaaaaaaaaaaaaaaaaaaaaaaaaaa
aaaaaaaaaaaaaaaaaaaaaaFFFFFFYFnaFaaaasFksoFFFFFFFFFFFFFFFFFFaaaassoFaaFaaaFaaFFFFFaaaaaaFFFFFFFFFFaaaaaFFFFaaaaaaaaaaaaaaaaaaaaaaaaaaaaaaaaaaaaaaaaaaa
aaaaaaaaaaaaaaaaaaaaaaaaFFFFFFFaaaFsaaasksaFFFFFFFFFFFFFFFFaaaaaoassaaaaaFFFFFFFFFFaaaaaFFFFFFFFFaaaaaaFFFFaaaaaaaaaaaaaaaaaaaaaaaaaaaaaaaaaaaaaaaaaaa
aaaaaaaaaaaaaaaaaaaaaaaaFdFsaaFoFaaZaasavaFFFPFFFFFFFFFFFFaaaaaaasskaaaoaFFAFFFFFFFFaaaaFFFFFFFFaaaaaaaFFFaaaaaaaaaaaaaaaaaaaaaaaaaaaaaaaaaaaaaaaaaaaa
aaaaaaaaaaaaaaaaaaaaaaaFXaaaaaFaaFkasaakaaaaaakFFFFFFFFFFFaaaaaaaasaaaFaaFFFFFFFFFFFFaaaFFFFFFFFaaaaaaaFFFaaaaaaaaaaaaaaaaaaaaaaaaaaaaaaaaaaaaaaaaaaaa
aaaaaaaaaaaaaaaaaaaFFXaFFfFaoaFaasaaadaakaaaoaaFFFFFFFFFFFaaaaaaasaaoaaaaFFFFFFFFFFFdaaaFFFFFFFFaaaaaaaFFaaaaaaaaaaaaaaaaaaaaaaaaaaaaaaaaaaaaaaaaaaaaa
aaaaaaaaaaaaaaaassFFFaoakssaFsaasavaaaaaaasaaaoFFFFFFFFFFaaaaaaaaaaPFFFFdFFFFQQQQQFFFaaaFFFFFFFaaaaaaaaFaaaaaaaaaaaaaaaaaaaaaaaaaaaaaaaaaaaaaaaaaaaaaa
aaaaaaaaaaaaaaaFFFssaaaaassaaaagskaaaaaakaagFFFFFFFFFFFFFaaaaaaasoFFFFFFFFFFFQFFFFFFaaaaFFFFFFFaaaaaaaaaaaaaaaaaaaaaaaaaaaaaaaaaaaaaaaaaaaaaaaaaaaaaaa
aaaaaaaaaaaaaaaFFFaaaakaaaFassaakFFaaaoaaoaaXFFFPFFFFFFFaaaaaoaaksaFFFFFFFFFQFFFFFFaaaaaFFFFFFaaaaaaaaaaaaaaaaaaaaaaaaaaaaaaaaaaaaaaaaaaaaaaaaaaaaaaaa
aaaaaaaaaaaaaaFFFFaaoaksdsasossvFaaagaFFFkaasaaFFFFFFFFaaaaaaaaavaFFFPFFFFFQFFFQFFaaaaaaFFFFFaaaaaaaaaaaaaaaaaaaaaaaaaaaaaaaaaaaaaaaaaaaaaaaaaaaaaaaaa
aaaaaaaaaaaaaaFFFFoaaaaaaaFasakaaFFaaaXFFaaoasaFFFFFFFaaaaaaaaaaaaaaaakFFFQQFFQFFFaaaaaaFFFFaaaaaaaaaaaaaaaaaaaaaaaaaaaaaaaaaaaaaaaaaaaaaaaaaaaaaaaaaa
aaaaaaaaaaaaaaFFFFwPFFFoaaaSaaaaaaaaaFFFXaaaasoFFFPFFaaaaaaaaaaakaaaoaaFFFFFFQFFFFaaaaaaPFFaaaaaaaaaaaaaaaaaaaaaaaaaaaaaaaaaaaaaaaaaaaaaaaaaaaaaaaaaaa
aaaaaaaaaaaaaaFFFFPFFFFFXFXXFXFXFFdaaFFaaFXFlFFFFFPPFaaaaaaaaaaaaasaaaoFFFFFQQFFFaaaaaaaPPFaaaaaaaaaaaaaaaaaaaaaaaaaaaaaaaaaaaaaaaaaaaaaaaaaaaaaaaaaaa
aaaaaaaaaaaaaaaFFFFFFFFlFFFFFFdFFdXaoaaFaFFFFFFFFdFFFaaaaaaaoaaakaagFFFFFFFFFFFFFaaaaaaaFFFaaaaaaaaaaaaaaaaaaaaaaaaaaaaaaaaaaaaaaaaaaaaaaaaaaaaaaaaaaa
aaaaaaaaaaaaaaaaFdFFFFFFFFFFFFFFFFFFFFsoaXFFXFFFFFFFaaaaaaaaaaaaaoaaXFFFPFFFFFFFaaaaaaaaFFaaaaaaaaaaaaaaaaaaaaaaaaaaaaaaaaaaaaaaaaaaaaaaaaaaaaaaaaaaaa
aaaaaaaaaaaaaaaaFFFFFFFFFFFdFFFFFFFFFFaaaaaaFFXFXaaaaaaaaaoaaaaaFkaasaaFFFFFFFFaaaaaaaaaaaaaaaaaaaaaaaaaaaaaaaaaaaaaaaaaaaaaaaaaaaaaaaaaaaaaaaaaaaaaaa
aaaaaaaaaaaaaaaaaaFFFdFFFFFFFFFFFFaaaaaaaaaoFFFFFaoaaaaaaaaaaaaaFaaoasaFFFFFFFaaaaaaaaaaoaaaaaaaaaaaaaaaaaaaaaaaaaaaaaaaaaaaaaaaaaaaaaaaaaaaaaaaaaaaaa
aaaaaaaaaaaaaaaaaaaaaFFFFFFFFFaaoaaaaaaaaaaaaaaaaaaaaaaaaaaaaaaaXaaaasoFFFPFFaaaaaaaaaaaaaaaaaaaaaaaaaaaaaaaaaaaaaaaaaaaaaaaaaaaaaaaaaaaaaaaaaaaaaaaaa
aaaaaaaaaaaaaaaaaaaaaaaaaaaaaaaaaaaaaaFFFFPFFFFFXFXXFXFXFFdaaFFaaFXFlFFFFFPPFaaaaaaaaaaaaaaaaaaaaaaaaaaaaaaaaaaaaaaaaaaaaaaaaaaaaaaaaaaaaaaaaaaaaaaaaa
aaaaaaaaaaaaaaaaaaaaaaaaaaaaaaaaaaaaaaaFFFFFFFFlFFFFFFdFFdXaoaaFaFFFFFFFFdFFFaaaaaaaaaaaaaaaaaaaaaaaaaaaaaaaaaaaaaaaaaaaaaaaaaaaaaaaaaaaaaaaaaaaaaaaaa
aaaaaaaaaaaaaaaaaaaaaaaaaaaaaaaaaaaaaaaaFdFFFFFFFFFFFFFFFFFFFFsoaXFFXFFFFFFFaaaaaaaaaaaaaaaaaaaaaaaaaaaaaaaaaaaaaaaaaaaaaaaaaaaaaaaaaaaaaaaaaaaaaaaaaa
aaaaaaaaaaaaaaaaaaaaaaaaaaaaaaaaaaaaaaaaFFFFFFFFFFFdFFFFFFFFFFaaaaaaFFXFXaaaaaaaaaaaaaaaaaaaaaaaaaaaaaaaaaaaaaaaaaaaaaaaaaaaaaaaaaaaaaaaaaaaaaaaaaaaaa
aaaaaaaaaaaaaaaaaaaaaaaaaaaaaaaaaaaaaaaaaaFFFdFFFFFFFFFFFFaaaaaaaaaoFFFFFaoaaaaaaaaaaaaaaaaaaaaaaaaaaaaaaaaaaaaaaaaaaaaaaaaaaaaaaaaaaaaaaaaaaaaaaaaaaa
aaaaaaaaaaaaaaaaaaaaaaaaaaaaaaaaaaaaaaaaaaaaaFFFFFFFFFaaoaaaaaaaaaaaaaaaaaaaaaaaaaaaaaaaaaaaaaaaaaaaaaaaaaaaaaaaaaaaaaaaaaaaaaaaaaaaaaaaaaaaaaaaaaaaaa
aaaaaaaaaaaaaaaaaaaaaaaaaaaaaaaaaaaaaaaaaaaaaaaaaaaaaaaaaaaaaaaaaaaaaaaaaaaaaaaaaaaaaaaaaaaaaaaaaaaaaaaaaaaaaaaaaaaaaaaaaaaaaaaaaaaaaaaaaaaaaaaaaaaaaa
aaaaaaaaaaaaaaaaaaaaaaaaaaaaaaaaaaaaaaaaaaaaaaaaaaaaaaaaaaaaaaaaaaaaaaaaaaaaaaaaaaaaaaaaaaaaaaaaaaaaaaaaaaaaaaaaaaaaaaaaaaaaaaaaaaaaaaaaaaaaaaaaaaaaaa
aaaaaaaaaaaaaaaaaaaaaaaaaaaaaaaaaaaaaaaaaaaaaaaaaaaaaaaaaaaaaaaaaaaaaaaaaaaaaaaaaaaaaaaaaaaaaaaaaaaaaaaaaaaaaaaaaaaaaaaaaaaaaaaaaaaaaaaaaaaaaaaaaaaaaa
aaaaaaaaaaaaaaaaaaaaaaaaaaaaaaaaaaaaaaaaaaaaaaaaaaaaaaaaaaaaaaaaaaaaaaaaaaaaaaaaaaaaaaaaaaaaaaaaaaaaaaaaaaaaaaaaaaaaaaaaaaaaaaaaaaaaaaaaaaaaaaaaaaaaaa
aaaaaaaaaaaaaaaaaaaaaaaaaaaaaaaaaaaaaaaaaaaaaaaaaaaaaaaaaaaaaaaaaaaaaaaaaaaaaaaaaaaaaaaaaaaaaaaaaaaaaaaaaaaaaaaaaaaaaaaaaaaaaaaaaaaaaaaaaaaaaaaaaaaaaa
aaaaaaaaaaaaaaaaaaaaaaaaaaaaaaaaaaaaaaaaaaaaaaaaaaaaaaaaaaaaaaaaaaaaaaaaaaaaaaaaaaaaaaaaaaaaaaaaaaaaaaaaaaaaaaaaaaaaaaaaaaaaaaaaaaaaaaaaaaaaaaaaaaaaaa
aaaaaaaaaaaaaaaaaaaaaaaaaaaaaaaaaaaaaaaaaaaaaaaaaaaaaaaaaaaaaaaaaaaaaaaaaaaaaaaaaaaaaaaaaaaaaaaaaaaaaaaaaaaaaaaaaaaaaaaaaaaaaaaaaaaaaaaaaaaaaaaaaaaaaa
"}
