"a" = (/turf/unsimulated/floor/frozenground,/area/polarplanet/street)
"d" = (/obj/structure/flora/tree/pine,/obj/structure/snow,/turf/unsimulated/floor/frozenground,/area/polarplanet/street)
"f" = (/obj/structure/flora/tree/pine,/obj/structure/flora/grass/green,/obj/structure/flora/grass/green,/turf/unsimulated/floor/frozenground,/area/polarplanet/street)
"g" = (/obj/structure/flora/tree/pine,/obj/structure/flora/grass/brown,/turf/unsimulated/floor/frozenground,/area/polarplanet/street)
"h" = (/obj/structure/flora/grass/brown,/obj/structure/flora/grass/brown,/obj/structure/flora/grass/green,/turf/unsimulated/floor/frozenground,/area/polarplanet/street)
"i" = (/mob/living/simple_animal/hostile/retaliate/beast/diyaab,/obj/structure/snow,/turf/unsimulated/floor/frozenground,/area/polarplanet/street)
"j" = (/obj/structure/gravemarker/cross,/obj/structure/snow,/turf/unsimulated/floor/frozenground,/area/polarplanet/street)
"k" = (/obj/structure/flora/grass/green,/turf/unsimulated/floor/frozenground,/area/polarplanet/street)
"l" = (/obj/structure/flora/tree/pine,/obj/structure/flora/grass/brown,/obj/structure/snow,/turf/unsimulated/floor/frozenground,/area/polarplanet/street)
"n" = (/obj/structure/flora/grass/brown,/obj/structure/flora/grass/green,/obj/structure/snow,/turf/unsimulated/floor/frozenground,/area/polarplanet/street)
"o" = (/obj/structure/flora/tree/pine,/turf/unsimulated/floor/frozenground,/area/polarplanet/street)
"s" = (/obj/structure/flora/grass/brown,/turf/unsimulated/floor/frozenground,/area/polarplanet/street)
"v" = (/obj/structure/flora/tree/pine,/obj/structure/flora/grass/green,/turf/unsimulated/floor/frozenground,/area/polarplanet/street)
"x" = (/obj/structure/flora/grass/brown,/obj/structure/flora/grass/brown,/obj/structure/flora/grass/green,/obj/structure/snow,/turf/unsimulated/floor/frozenground,/area/polarplanet/street)
"F" = (/obj/structure/snow,/turf/unsimulated/floor/frozenground,/area/polarplanet/street)
"G" = (/obj/structure/flora/tree/pine,/obj/structure/flora/grass/green,/obj/structure/flora/grass/green,/obj/structure/snow,/turf/unsimulated/floor/frozenground,/area/polarplanet/street)
"I" = (/obj/structure/flora/grass/green,/obj/structure/flora/grass/green,/turf/unsimulated/floor/frozenground,/area/polarplanet/street)
"K" = (/obj/structure/flora/tree/pine,/obj/structure/flora/grass/green,/obj/structure/snow,/turf/unsimulated/floor/frozenground,/area/polarplanet/street)
"N" = (/obj/structure/flora/grass/green,/obj/structure/flora/grass/green,/obj/structure/snow,/turf/unsimulated/floor/frozenground,/area/polarplanet/street)
"P" = (/obj/structure/flora/grass/green,/obj/structure/snow,/turf/unsimulated/floor/frozenground,/area/polarplanet/street)
"S" = (/obj/structure/flora/grass/brown,/obj/structure/flora/grass/brown,/turf/unsimulated/floor/frozenground,/area/polarplanet/street)
"T" = (/obj/structure/flora/grass/brown,/obj/structure/flora/grass/brown,/obj/structure/snow,/turf/unsimulated/floor/frozenground,/area/polarplanet/street)
"U" = (/obj/structure/flora/grass/brown,/obj/structure/flora/grass/green,/turf/unsimulated/floor/frozenground,/area/polarplanet/street)
"X" = (/obj/structure/flora/grass/brown,/obj/structure/snow,/turf/unsimulated/floor/frozenground,/area/polarplanet/street)
"Z" = (/obj/structure/flora/tree/pine,/obj/structure/flora/grass/brown,/obj/structure/flora/grass/green,/turf/unsimulated/floor/frozenground,/area/polarplanet/street)

(1,1,1) = {"
aaaaaaaaaaaaaaaaaaaaaFaaaFFFaaaaaaaaaaaaaaaaaaaaaa
aaaaaaaaaaaaaaaaaaaaFFFFFdFFFFFFaaaaaaaaaaaaaaaaaa
aaaaaaaaaaaaaaaaaaaFFFFXFFFFFFFFFaaaaaaaaaaaaaaaaa
aaaaaaaaaaaaaaaaaaaaFFFFaFFaFFFFFFFaaaaaaaaaaaaaaa
aaaaaaaaaaaaaaaaaaFFFFgaaFnadFFFPdFaFaaaaaaaaaaaaa
aaaaFaaaaaaaaaaaaaFFFFFFsaaaFFPFFFFFaaaFaaaaFFaaaa
aaaasaaaaaaaaaaaaaFFFFPFasaaasaaFFFFaaaaFaFaaaaaaa
aaoasFFaaFFaaaaaaaaFFFPIakIasaaaFFFFFFaaaaaFaaaaaa
aaaFaXFFadFFFaaaaaaFdFaXsaavakFPPPFPFFFFFFaaaFaaaa
aaaFagPFFFFFFkaaaaaFFFFadjXFFPsaoaaFFFFFFFFFFFFaaa
aaaaaaaaaaaFFFFkaasaXFaFaFFFFFFFaaZFFXFKFFFFPFFaaa
aaaaaFskXasosassaaPaFFaaaaFFFFFFakasaFPFFFFFakFaaa
aaaaaaaakaaaPaFoaaFFFFoaFaFFFFaXaaaaoaakaaaoaaFFaa
aaaaFaaasPaFFFFFFsFFFFaaakaUaFaaavaaaaaaasaaaoFFFa
aaaaoaaaaakXXFnFFaaaaaaaaaaaFaaaaaaaaaakaagaaaFFaa
aaaaaaPFosFFFaFXFaaaaaoasaFaoFFFFFFFFdFFdFFXFFFPaa
aaaaaaFaaadPFaFXaaoaasaaaaaaFFFPFFFlFFFFPFFXFFFaaa
aaaaaaFkaaFFXaaaUaaksafaaoaaaFXFFFFFFXFFFFdFXFaaaa
aaaaaaFaaaaaFnFadFFFFFFiFiFFFFFFFFFFFFFFFFFaFaaaaa
aaaaaaavFFsaaasFaXkoFdFFFFFFFFFFFFFFFFFFFFaaaaaaaa
aaaaaaaaPPaaaaagaFFnFFiFFFiFFFFFFdFFFFFFFFaaaaaaaa
aaaaaaoaaakFdFFPXFXahFFFiFFFFFFFFFFFFFFFFFaaaaaaaa
aaaaaaaaaaaUFFFFFFnsoFFFFFFFFFFFFFFFFFFFFFFaaaaaaa
aaaaaaaaaaaFdFFFFFFaasaFPFnaFFPFFFdFFFFFFFFaaaaaaa
aaaaaaaaaaFFFaaPaUaaFaaFXFPsdFFFFFFFFFFFFFFFaaaaaa
aaaaaaaaaaFFFaaaaaaFaFsaaaskXFFFFFdFFFFFFFFFaaaaaa
aaaaaaaaaFFFdasaFaoaFaZaasavFFFFPFFFFFFFFFFaaaaaaa
aaaaaaaaaFFXFaaaaaFFFPasaakFFFFFFFFFFFFFFFFaaaaaaa
aaaaaaaaaFFFGaaoaaFFXFaaoaFPFaFdFFFFFFFFFFaaaaaaaa
aaaaaaaaaFFFFsaaaFFFFaaaFaFFFsFFFFFFFFFFFFaaaaaaaa
aaaXFaaaaFFFFFoaaFFFaaFFaaakXaFFdFFFFFFFFFaaaaaaaa
aoFXFFaaaaFFFFaaaaaaaFaaadFFaaXFFFFFFFFFaFFaaaaaaa
aaFFXFaaoaFFFFaaaaaoaaagaFFFaaFFFFFFFFFaaaFaaaaaaa
aaaFlPaaaaaaFFaoaaFasssaasFFagFFFnFdFFakoFFaaaaaaa
aaaFFaFFaaaaaFkaasFXFaaaaaasPFFXFaaaFPaaaFFaaaaaaa
aaaFaXPXasosassaakaFFoaaaaaakkFFXaaaXFaaFFFFaaaaaa
aaaaaFFPFaaPFaoaaaaakaaoaaaaaPNFkIasFFaaFFFFoaaaaa
aaaaaaasPaaFFFFFXFaaasaaasoaaassaavakFkkPFPPFaaaaa
aaaoaFaaakssanFFaaaaaakaIaosaaaoasaaksaoaaaFFFaaaa
aaaaaPaosaaFFFXFaaaaoaSoaaaaasaaskaaaFFFFaaFFaaaaa
aaaaaaaFaokFFFXFaoaaskaIaosFFFoaFaaoFFFFXFFaaaaaaa
aaaaaakaaaaFXaaUaakXFToaaaaFXFaaFFFFFdFFFXFaoaaaaa
aaaaaFFFFFasaUaoaaaFFPsUnFFFPXFaFFFFFFFFaaaaaaaaaa
aaaaaFKFFFaaUoaFXPdFFPFFdXFFFFFaaFFFaaaaaaaaaaaaaa
aaaaaaaPPnFFdagFFFnFFFFFkFXPdFFoaFFFaaaaaaaaaaaaaa
aaaaaoaFFFXFFFPXFXFxnFakaaFFnFFaaaaaaaaaaaaaaaaaaa
aaaaaaaaFFagaXFFFFFFFFaaaaaXFxnFaaaaaaaaaaaaaaaaaa
aaaaaaaaaaaksFFFFaaFFaaaaaaaaaaaaaaaaaaaaaaaaaaaaa
aaaaaaaaaaaaaaFFaaaaaaaaaaaaaaaaaaaaaaaaaaaaaaaaaa
aaaaaaaaaaaaaaaaaaaaaaaaaaaaaaaaaaaaaaaaaaaaaaaaaa
"}
