"a" = (/turf/unsimulated/floor/frozenground,/area/polarplanet/street)
"j" = (/obj/structure/snow,/obj/structure/flora/grass/green,/turf/unsimulated/floor/frozenground,/area/polarplanet/street)
"q" = (/obj/structure/snow,/obj/structure/flora/grass/brown,/obj/structure/flora/grass/green,/turf/unsimulated/floor/frozenground,/area/polarplanet/street)
"w" = (/mob/living/simple_animal/hostile/retaliate/beast/samak,/obj/structure/snow,/turf/unsimulated/floor/frozenground,/area/polarplanet/street)
"X" = (/obj/structure/snow,/turf/unsimulated/floor/frozenground,/area/polarplanet/street)
"Y" = (/obj/structure/snow,/obj/structure/flora/grass/brown,/turf/unsimulated/floor/frozenground,/area/polarplanet/street)

(1,1,1) = {"
aaaaaaaaaaaaaaaaaaaaaaaaaaaaaaaaaaaaaaaaaaaaaaaaaa
aaaaaaaaaaaaaaaaaaaaaaaaaaaaaaaaaaaaaaaaaaaaaaaaaa
aaaaaaaaaaaaaaaaaaaaaaaaaaaaaaaaaaaaaaaaaaaaaaaaaa
aaaaaaaaaaaaaaaaaaaaaaaaaaaaaaaaaaaaaaaaaaaaaaaaaa
aaaaaaaaaaaaaaaaaaaaaaaaaaaaaaaaaaaaaaaaaaaaaaaaaa
aaaaaaaaaaaaaaaaaaaaaaaaaaaaaaaaaaaaaaaaaaaaaaaaaa
aaaaaaaaaaaaaaaaaaaaaaaaaaaaaaaaaaaaaaaaaaaaaaaaaa
aaaaaaaaaaaaaaaaaaaaaaaaaaaaaaaaaaaaaaaaaaaaaaaaaa
aaaaaaaaaaaaaaaaaaaaaaaaaaaaaaaaaaaaaaaaaaaaaaaaaa
aaaaaaaaaaaaaaaaaXXaaaaaaaaaaaaaaaaaaaaaaaaaaaaaaa
aaaaaaaaaaaaaaaaXXXXXaaaaaaaaaaaaaaaaaaaaaaaaaaaaa
aaaaaaaaaaaaaaaaXXXYXXXaaaaaaaaXXaaaaaaaaaaaaaaaaa
aaaaaaaaaaaaaaaaaXXYYXXaaaaaaaXYXXaaaaaaaaaaaaaaaa
aaaaaaaaaaaaaaaaaaXXjYXXaaaaaXXjXaaaaXXXaaaaaaaaaa
aaaaaaaaaaaaaaaaaaaXXXXXaaaXYYYXaaaXXXYXaaaaaaaaaa
aaaaaaaaaaaaaaaXXaaXXXXaaXXXXXXaaXXXXYXXaaaaaaaaaa
aaaaaaaaaaaaaaXXXXXjXXYXXXXXXXXXXXXYYXXaaaaaaaaaaa
aaaaaaaaaaaaaXXYXXjXXYXXXYXXXYYXXXYYXXaaaaaaaaaaaa
aaaaaaaaaaaaaaXXXYjYYYXXXXXXXXXXYXXXXXaaaaaaaaaaaa
aaaaaaaaaaaaaaXXXXYXYXXXXXjXXXXXYXXXaaaaaaaaaaaaaa
aaaaaaaaaaaaaaaXXXXYYXXXXjXjXXwXXXXXaaaaaaaaaaaaaa
aaaaaaaaaaaaaaaaaXjXXXXwXYXXXjXXXYXXaaaaaaaaaaaaaa
aaaaaaaaaaaaaaaaXXXXXXXXXXXYXjXXXYXXXaaaaaaaaaaaaa
aaaaaaaaaaaaaaaaXXXXjXXXXjXXXXXXXXXXXXaaaaaaaaaaaa
aaaaaaaaaaaaaaaXXXXXXYXXXXjXXYXjYXXYXXaaaaaaaaaaaa
aaaaaaaaaaaaaaaaXXYXwXXXwXXwXYXXXXXXXYXaaaaaaaaaaa
aaaaaaaaaaaaaaaaXXYXXXXXXXXXXXXXXXXjXYXaaaaaaaaaaa
aaaaaaaaaaaaaaaXXXYXXXXXjXYXXYXXwjXXXXaaaaaaaaaaaa
aaaaaaaaaaaaaaaXXXXXwXXYXXXXXYXXXXYYXXaaaaaaaaaaaa
aaaaaaaaaaaaaaXXXXXXXXYXXXXXXXYXXXXXXaaaaaaaaaaaaa
aaaaaaaaaaaaaaXXXXXjXYYXXXwXXXjXXXYXaaaaaaaaaaaaaa
aaaaaaaaaaaaaaaXXYqXYjXXXXXXXjXXXXYXaaaaaaaaaaaaaa
aaaaaaaaaaaaaaaXYYXXYXXjXXXXXXXXjXjXXaaaaaaaaaaaaa
aaaaaaaaaaaaaaYYXXXXYYXXXXXXYXXXwXXYXXaaaaaaaaaaaa
aaaaaaaaaaaaaXXXaXXXXXXXjXXXXXXXXXXYXXaaaaaaaaaaaa
aaaaaaaaaaaaXjXXaXXXXXXXXXYYXjXXXXXXXXXaaaaaaaaaaa
aaaaaaaaaaaaXXYXaaaXjXXXXXXXXXXaaaXXXYXXaaaaaaaaaa
aaaaaaaaaaaaaXjXaaaXXYYXXXXXaaaaaaXXXXXaaaaaaaaaaa
aaaaaaaaaaaaaaXXXaaaaXXXXaaaaaaaaaaXXXaaaaaaaaaaaa
aaaaaaaaaaaaaaaXaaaaaaaaaaaaaaaaaaaaaaaaaaaaaaaaaa
aaaaaaaaaaaaaaaaaaaaaaaaaaaaaaaaaaaaaaaaaaaaaaaaaa
aaaaaaaaaaaaaaaaaaaaaaaaaaaaaaaaaaaaaaaaaaaaaaaaaa
aaaaaaaaaaaaaaaaaaaaaaaaaaaaaaaaaaaaaaaaaaaaaaaaaa
aaaaaaaaaaaaaaaaaaaaaaaaaaaaaaaaaaaaaaaaaaaaaaaaaa
aaaaaaaaaaaaaaaaaaaaaaaaaaaaaaaaaaaaaaaaaaaaaaaaaa
aaaaaaaaaaaaaaaaaaaaaaaaaaaaaaaaaaaaaaaaaaaaaaaaaa
aaaaaaaaaaaaaaaaaaaaaaaaaaaaaaaaaaaaaaaaaaaaaaaaaa
aaaaaaaaaaaaaaaaaaaaaaaaaaaaaaaaaaaaaaaaaaaaaaaaaa
aaaaaaaaaaaaaaaaaaaaaaaaaaaaaaaaaaaaaaaaaaaaaaaaaa
aaaaaaaaaaaaaaaaaaaaaaaaaaaaaaaaaaaaaaaaaaaaaaaaaa
"}
