"a" = (/obj/structure/table/woodentable,/obj/item/device/camera,/turf/simulated/floor/trim/wood/broken6,/area/template_noop)
"h" = (/turf/simulated/floor/plating,/area/template_noop)
"l" = (/turf/simulated/floor/trim/wood,/area/template_noop)
"o" = (/obj/machinery/photocopier,/turf/simulated/floor/trim/wood,/area/template_noop)
"t" = (/obj/structure/table/woodentable,/obj/item/canvas/nineteen_nineteen,/obj/item/canvas/twentyfour_twentyfour,/obj/item/canvas/twentythree_nineteen,/obj/item/storage/fancy/crayons,/obj/item/storage/fancy/crayons,/turf/simulated/floor/trim/wood,/area/template_noop)
"z" = (/turf/simulated/floor/trim/wood/broken3,/area/template_noop)
"B" = (/obj/structure/sign/poster{pixel_y = -32},/turf/simulated/floor/plating,/area/template_noop)
"I" = (/obj/structure/easel,/obj/item/canvas/nineteen_nineteen,/turf/simulated/floor/trim/wood,/area/template_noop)
"N" = (/obj/structure/table/woodentable,/obj/item/device/camera_film,/obj/item/device/camera_film,/turf/simulated/floor/trim/wood,/area/template_noop)
"Q" = (/obj/structure/easel,/obj/item/canvas/nineteen_nineteen,/turf/simulated/floor/plating,/area/template_noop)
"S" = (/turf/simulated/floor/trim/wood/broken6,/area/template_noop)
"U" = (/mob/living/simple_animal/mouse/white,/turf/simulated/floor/trim/wood,/area/template_noop)

(1,1,1) = {"
QIhtN
SUlll
alzBo
"}
