"a" = (/turf/simulated/floor/tiled/dirty,/area/template_noop)
"h" = (/obj/effect/decal/cleanable/blood/gibs/limb,/turf/simulated/floor/tiled/dirty,/area/template_noop)
"o" = (/obj/structure/table/reinforced,/obj/item/device/flashlight,/obj/item/storage/toolbox/mechanical,/turf/simulated/floor/tiled/dirty,/area/template_noop)
"p" = (/obj/structure/table/rack,/obj/item/book/wiki/engineering_hacking,/obj/item/book/wiki/engineering_construction,/obj/item/book/wiki/engineering_guide,/turf/simulated/floor/plating,/area/template_noop)
"r" = (/obj/structure/table/reinforced,/obj/item/tank/emergency,/obj/item/tank/emergency,/obj/item/clothing/mask/breath/emergency,/obj/item/clothing/mask/breath/emergency,/turf/simulated/floor/tiled/dirty,/area/template_noop)
"F" = (/obj/effect/floor_decal/industrial/hatch/orange,/turf/simulated/floor/tiled/dirty,/area/template_noop)
"N" = (/obj/structure/reagent_dispensers/fueltank,/turf/simulated/floor/tiled/dirty,/area/template_noop)
"Q" = (/obj/structure/table/reinforced,/obj/item/wrench,/obj/item/storage/box/lights/mixed,/turf/simulated/floor/tiled/dirty,/area/template_noop)
"R" = (/obj/structure/table/rack,/obj/random/maintenance,/obj/random/maintenance,/turf/simulated/floor/tiled/dirty,/area/template_noop)
"T" = (/turf/simulated/floor/plating,/area/template_noop)
"X" = (/obj/effect/floor_decal/industrial/hatch/orange,/obj/machinery/portable_atmospherics/canister/air,/turf/simulated/floor/tiled/dirty,/area/template_noop)

(1,1,1) = {"
orTRp
FThaa
XNaaQ
"}
