"bB" = (/obj/structure/cargo_container/green{dir = 4},/turf/unsimulated/beach/sand,/area/ghost_arena)
"cN" = (/obj/structure/cargo_container/horizontal{dir = 4},/turf/unsimulated/floor{dir = 5; icon_state = "vault"},/area/ghost_arena)
"ei" = (/obj/structure/cargo_container/horizontal{dir = 1},/turf/unsimulated/beach/sand,/area/ghost_arena)
"em" = (/obj/structure/barricade,/turf/unsimulated/beach/sand,/area/ghost_arena)
"eV" = (/obj/structure/largecrate,/turf/unsimulated/floor{icon_state = "asteroidfloor"},/area/ghost_arena)
"eW" = (/obj/structure/cargo_container,/turf/unsimulated/beach/sand,/area/ghost_arena)
"gL" = (/obj/effect/floor_decal/industrial/warning{dir = 4},/obj/effect/floor_decal/industrial/warning,/obj/structure/table/standard,/turf/unsimulated/floor{icon_state = "asteroidfloor"},/area/ghost_arena)
"ho" = (/obj/effect/floor_decal/industrial/warning{dir = 4},/turf/unsimulated/floor,/area/ghost_arena)
"ia" = (/obj/structure/largecrate,/turf/unsimulated/floor{dir = 5; icon_state = "vault"},/area/ghost_arena)
"iH" = (/obj/structure/cargo_container/horizontal,/turf/unsimulated/floor{dir = 5; icon_state = "vault"},/area/ghost_arena)
"jE" = (/obj/effect/floor_decal/stairs{dir = 1},/turf/unsimulated/beach/sand,/area/ghost_arena)
"kq" = (/obj/effect/landmark/ghost_arena_spawn,/turf/unsimulated/beach/sand,/area/ghost_arena)
"kL" = (/obj/effect/landmark/ghost_arena_spawn,/turf/unsimulated/floor{icon_state = "asteroidfloor"},/area/ghost_arena)
"lX" = (/obj/machinery/door/unpowered/simple/wood,/turf/unsimulated/beach/sand,/area/ghost_arena)
"mQ" = (/obj/effect/floor_decal/industrial/warning{dir = 8},/turf/unsimulated/floor,/area/ghost_arena)
"no" = (/obj/structure/cargo_container/nt{dir = 4},/turf/unsimulated/beach/sand,/area/ghost_arena)
"ps" = (/obj/effect/floor_decal/industrial/warning{dir = 8},/obj/structure/table/standard/flipped/west,/turf/unsimulated/floor{dir = 5; icon_state = "vault"},/area/ghost_arena)
"qD" = (/obj/structure/cargo_container/horizontal,/turf/unsimulated/beach/sand,/area/ghost_arena)
"rk" = (/turf/unsimulated/mineral,/area/ghost_arena)
"wA" = (/obj/effect/floor_decal/industrial/warning{dir = 4},/obj/effect/floor_decal/industrial/warning,/obj/structure/barricade,/turf/unsimulated/floor,/area/ghost_arena)
"wM" = (/turf/unsimulated/wall,/area/ghost_arena)
"xf" = (/obj/effect/floor_decal/industrial/warning,/obj/structure/table/standard,/turf/unsimulated/floor{icon_state = "asteroidfloor"},/area/ghost_arena)
"yu" = (/obj/structure/cargo_container/horizontal{dir = 1},/turf/unsimulated/floor{dir = 5; icon_state = "vault"},/area/ghost_arena)
"yz" = (/obj/effect/floor_decal/industrial/warning{dir = 4},/turf/unsimulated/floor{icon_state = "asteroidfloor"},/area/ghost_arena)
"zj" = (/obj/effect/floor_decal/industrial/warning{dir = 4},/obj/effect/floor_decal/industrial/warning{dir = 1},/turf/unsimulated/floor,/area/ghost_arena)
"zB" = (/obj/structure/barrel,/turf/unsimulated/beach/sand,/area/ghost_arena)
"Aw" = (/obj/effect/floor_decal/industrial/warning{dir = 4},/obj/structure/table/standard/flipped/east,/turf/unsimulated/floor,/area/ghost_arena)
"AJ" = (/obj/structure/cargo_container{dir = 4},/turf/unsimulated/beach/sand,/area/ghost_arena)
"CE" = (/obj/effect/floor_decal/stairs{dir = 1},/turf/unsimulated/floor{dir = 5; icon_state = "vault"},/area/ghost_arena)
"Dd" = (/obj/machinery/door/unpowered/simple/wood,/turf/unsimulated/floor{dir = 5; icon_state = "vault"},/area/ghost_arena)
"Dg" = (/turf/unsimulated/beach/sand,/area/ghost_arena)
"Dw" = (/obj/effect/landmark/ghost_arena_spawn,/turf/unsimulated/floor{dir = 5; icon_state = "vault"},/area/ghost_arena)
"Es" = (/obj/effect/floor_decal/industrial/warning{dir = 8},/turf/unsimulated/floor{dir = 5; icon_state = "vault"},/area/ghost_arena)
"EI" = (/obj/effect/floor_decal/industrial/warning{dir = 1},/turf/unsimulated/floor,/area/ghost_arena)
"Hp" = (/turf/unsimulated/floor{icon_state = "asteroidfloor"},/area/ghost_arena)
"KL" = (/obj/effect/floor_decal/industrial/warning,/obj/structure/barricade,/turf/unsimulated/floor,/area/ghost_arena)
"Lk" = (/turf/unsimulated/floor,/area/ghost_arena)
"Lv" = (/obj/structure/cargo_container/green{dir = 1},/turf/unsimulated/beach/sand,/area/ghost_arena)
"LA" = (/obj/structure/table/standard,/turf/unsimulated/floor{icon_state = "asteroidfloor"},/area/ghost_arena)
"Mg" = (/obj/structure/cargo_container/horizontal{dir = 4},/turf/unsimulated/beach/sand,/area/ghost_arena)
"MT" = (/obj/effect/landmark/ghost_arena_spawn/security,/turf/unsimulated/floor{dir = 5; icon_state = "vault"},/area/ghost_arena)
"Pz" = (/obj/structure/cargo_container/nt,/turf/unsimulated/beach/sand,/area/ghost_arena)
"QL" = (/obj/structure/largecrate,/turf/unsimulated/beach/sand,/area/ghost_arena)
"RL" = (/obj/effect/landmark/ghost_arena_spawn/greytide,/turf/unsimulated/floor{icon_state = "asteroidfloor"},/area/ghost_arena)
"SL" = (/obj/structure/cargo_container{dir = 1},/turf/unsimulated/beach/sand,/area/ghost_arena)
"Te" = (/obj/effect/floor_decal/industrial/warning{dir = 8},/obj/effect/floor_decal/industrial/warning,/obj/structure/largecrate,/turf/unsimulated/floor,/area/ghost_arena)
"VH" = (/obj/effect/floor_decal/stairs{dir = 4},/turf/unsimulated/floor{dir = 5; icon_state = "vault"},/area/ghost_arena)
"VK" = (/obj/effect/floor_decal/industrial/warning{dir = 4},/obj/structure/barricade,/turf/unsimulated/floor,/area/ghost_arena)
"Wp" = (/obj/effect/floor_decal/industrial/warning{dir = 8},/obj/effect/floor_decal/industrial/warning{dir = 1},/turf/unsimulated/floor,/area/ghost_arena)
"WM" = (/obj/structure/cargo_container/nt{dir = 1},/turf/unsimulated/beach/sand,/area/ghost_arena)
"Xp" = (/obj/structure/cargo_container/green,/turf/unsimulated/beach/sand,/area/ghost_arena)
"ZE" = (/turf/unsimulated/floor{dir = 5; icon_state = "vault"},/area/ghost_arena)

(1,1,1) = {"
wMwMwMwMwMwMwMwMwMwMwMwMwMwMwMwMwMwMwMwMwMwMwMwMwMwMwMwMwMwMwMwMwMwMwMwMwMwMwMwMwMwMwMwMwMwM
wMwMwMwMwMwMrkrkrkrkrkrkrkrkrkrkrkrkrkrkrkrkrkrkrkrkrkrkrkrkrkrkrkrkrkrkrkrkrkrkrkrkrkrkrkwM
wMwMHpHpHpwMrkrkrkrkrkrkrkrkrkrkrkrkrkrkrkrkrkrkrkrkrkrkrkrkrkrkrkrkrkrkrkrkrkrkrkrkrkrkrkwM
wMwMHpHpHpwMrkrkrkrkrkrkrkrkrkrkrkrkrkrkrkrkrkrkrkrkrkrkrkrkrkrkrkrkrkrkwMwMwMwMwMwMwMwMrkwM
wMwMHpHpHpwMrkrkrkrkrkrkrkrkrkrkrkrkrkrkrkrkrkrkrkrkrkrkrkrkrkrkrkrkrkrkwMDgDgDgDgDgDgwMrkwM
wMwMHpHpHpwMwMwMwMwMwMrkrkrkrkrkrkrkrkrkrkrkrkrkrkrkrkrkrkrkrkrkrkrkrkrkwMDgDgDgDgDgDgwMrkwM
wMwMHpkLHpyzDgDgDgDgwMwMrkrkrkrkrkrkrkrkrkrkrkrkrkrkrkwMwMwMwMwMwMwMwMwMwMjEjEjEDgDgDgwMwMwM
wMwMHpHpHpyzDgQLDgDgQLwMwMwMwMrkrkrkrkrkrkrkrkwMwMwMwMwMHpHpHpHpHpHpHpkLHpHpHphozBDgDgDgDgwM
wMwMHpHpHpyzDgDgDgQLDgwMDgDgwMwMwMwMwMrkrkrkrkwMZEZEZEwMHpHpHpHpHpHpHpHpHpHpHphoDgDgDgDgDgwM
wMwMHpHpHpyzeiDgDgDgDgwMDgDgDgPzWMnowMwMwMwMwMwMMTMTMTwMHpHpHpHpHpeVHpHpHpHpHphoDgDgDgwMwMwM
wMwMLALAxfgLMgDgDgDgDgwMDgDgDgDgDgDgDgDgDgDgDgwMMTMTMTwMHpHpLkKLKLKLKLKLKLHpHpVKDgDgDgwMwMwM
wMDgDgDgDgDgqDDgDgDgDgwMDgDgDgDgDgDgDgDgDgDgDgwMMTMTMTwMHpHpAwDgDgDgDgDgDgTeKLwADgDgDgwMwMwM
wMDgDgDgDgDgDgDgDgDgDgDgDgDgDgDgDgDgDgDgDgDgDgDgZEZEZEZEHpHpAwDgXpLvbBDgDgDgDgDgDgDgDgDgDgwM
wMDgDgDgDgDgDgDgDgDgDgDgDgDgDgDgDgDgDgDgDgDgDgDgZEZEZEZEHpHpHpDgDgDgDgDgDgDgDgDgDgDgDgDgDgwM
wMDgDgDgDgDgDgDgDgDgwMwMwMwMwMwMwMwMwMDgDgDgDgQLZEZEZEiaHpHphoDgDgDgDgDgDgDgDgDgDgDgDgDgDgwM
wMDgDgDgDgDgDgDgDgDgwMrkrkrkrkrkrkrkwMDgDgDgDgwMwMwMwMwMHpHpHpwMwMwMwMwMwMwMwMDgDgDgDgDgkqwM
wMDgDgDgDgDgDgDgDgDgwMrkrkrkrkrkrkrkwMDgDgDgDgwMwMwMwMwMHpHpHpwMrkrkrkrkrkrkwMDgDgDgDgDgDgwM
wMwMwMZEZEwMDgDgDgwMwMrkrkrkrkrkrkrkwMDgDgDgDgwMwMwMwMwMkLHpHpwMrkrkrkrkrkrkwMDgDgDgDgwMwMwM
wMrkwMZEZEwMwMDgwMwMrkwMwMwMwMwMwMwMwMwMlXlXwMwMwMwMwMwMHpHpHpwMrkrkrkrkrkrkwMDgDgDgDgwMwMwM
wMrkwMZEZEwMwMwMwMrkrkwMZEDwZEZEZEZEZEDgDgDgDgmQHpHpHpHpHpHpHpwMrkrkrkrkrkrkwMDgDgDgDgwMwMwM
wMrkwMZEZEwMrkrkrkrkrkwMZEZEZEZEZEZEZEDgDgDgDgEIHpHpHpHpHpHpHpwMrkrkrkrkrkrkwMDgDgDgDgwMwMwM
wMwMwMZEZEwMwMwMwMwMwMwMZEZEZEZEZEiaZEDgDgDgDgmQHpHpHpHpHpHpHpwMrkrkrkrkrkrkwMDgDgDgDgwMwMwM
wMyuZEZEZEZEZEZEZEZEZEwMCECEwMwMwMwMwMDgDgDgDgmQHpwMwMwMwMwMwMwMwMwMwMwMwMwMwMDgDgDgDgwMwMwM
wMcNZEDwZEZEZEZEZEZEZECEZEZEwMrkrkrkwMDgDgDgDgmQwMrkrkrkrkrkwMwMDgDgDgDgDgDgDgDgDgDgDgwMwMwM
wMiHZEZEZEZEZEZEZEZEZEVHZEZEwMrkrkrkwMDgDgDgDgmQwMrkrkrkrkrkwMDgeWSLAJDgDgDgDgDgDgDgDgwMwMwM
wMwMwMwMwMwMZEZEwMwMwMwMwMwMwMrkrkwMwMDgDgDgDgmQwMrkrkrkrkrkwMDgDgDgDgDgDgDgDgDgDgDgDgwMwMwM
wMrkrkrkrkwMZEZEwMrkrkrkrkrkrkrkrkwMzBDgDgDgDgmQwMrkrkrkrkrkwMDgDgDgDgDgDgDgDgDgDgDgDgEsDwwM
wMrkwMwMwMwMDgDgwMwMwMwMrkrkrkrkrkwMDgDgDgDgDgmQwMrkrkrkrkrkwMwMDdwMwMwMDgDgDgDgDgDgDgZEZEwM
wMrkwMDgDgDgDgDgDgDgDgwMrkrkrkrkwMwMDgDgDgDgDgmQwMrkrkrkrkrkwMZEZEZEwMwMkqDgDgDgDgDgDgpsZEwM
wMrkwMDgDgDgDgDgDgDgDgwMwMrkrkrkwMDgDgDgDgDgDgDgwMwMwMwMwMwMwMZEDwZEwMwMDgDgDgDgDgDgDgpsZEwM
wMrkwMDgDgDgDgDgDgDgDgDgwMrkrkrkwMDgDgDgDgDgDgDgzBDgDgDgDgDgwMZEZEZEwMwMDgDgDgememDgDgpsZEwM
wMrkwMDgDgDgDgDgDgDgDgDgwMrkrkrkwMkqDgDgDgDgDgDgDgDgDgDgDgDgwMwMDdwMwMwMDgDgDgemDgDgDgpsZEwM
wMrkwMDgDgDgDgkqDgDgDgDgwMrkrkrkwMDgDgDgDgDgDgDgDgDgDgDgDgDgDgDgDgDgwMwMzBDgDgemDgDgDgwMwMwM
wMrkwMDgDgDgDgDgDgDgDgDgwMrkrkrkwMDgDgDgDgDgDgDgDgDgDgDgDgDgDgDgDgDgwMwMwMwMwMwMDgDgDgwMrkwM
wMrkwMDgDgDgDgDgDgDgDgDgwMrkrkwMwMwMwMwMDgDgwMwMwMwMwMwMwMDgDgDgDgDgwMrkrkrkrkwMDgkqzBwMrkwM
wMrkwMDgDgDgDgDgDgDgDgwMwMrkrkrkrkrkrkwMDgDgwMwMwMwMwMwMwMDgDgDgDgDgwMrkrkrkrkwMDgDgDgwMrkwM
wMwMwMzBDgDgDgememDgemwMwMwMwMwMrkrkrkwMDgDgwMwMwMwMwMwMwMDgDgDgDgDgwMrkrkrkrkwMDgDgDgwMrkwM
wMwMDgDgDgDgDgDgDgDgDgDgwMwMDgwMrkrkrkwMDgDgwMwMwMwMwMwMwMDgDgDgDgDgwMrkrkrkrkwMwMwMwMwMrkwM
wMwMDgDgDgDgDgDgDgDgDgDgDgDgDgwMrkrkrkwMDgDgwMwMwMwMwMwMwMDgkqDgDgDgwMrkrkrkrkrkrkrkrkrkrkwM
wMwMDgDgDgDgDgDgDgDgDgDgDgDgDgwMrkrkrkwMDgDgwMDgwMDgDgDgDgDgDgDgDgDgwMrkrkrkrkrkrkrkrkrkrkwM
wMwMDgDgDgDgDgDgDgDgDgDgDgDgDgwMrkrkrkwMDgDgwMwMwMDgDgDgDgDgDgwMwMwMwMrkrkrkrkrkrkrkrkrkrkwM
wMwMDgDgDgDgDgDgDgDgDgDgDgDgDgwMwMwMwMwMDgDgDgDgDgDgDgDgDgDgwMrkrkrkrkrkrkrkrkrkrkrkrkrkrkwM
wMDgDgDgDgDgDgDgDgDgDgDgDgDgWpHpRLRLRLHpzjDgDgDgDgDgDgDgDgDgwMrkrkrkrkrkrkrkrkrkrkrkrkrkrkwM
wMDgDgDgDgDgDgDgDgDgDgzBDgDgmQkLRLRLRLHphoDgDgDgDgDgDgDgDgDgwMrkrkrkrkrkrkrkrkrkrkrkrkrkrkwM
wMwMwMwMDgDgDgDgDgDgDgwMwMDgmQHpRLRLRLHphoDgDgDgwMwMwMwMwMwMwMrkrkrkrkrkrkrkrkrkrkrkrkrkrkwM
wMwMwMwMwMwMwMwMwMwMwMwMwMwMwMwMwMwMwMwMwMwMwMwMwMwMwMwMwMwMwMwMwMwMwMwMwMwMwMwMwMwMwMwMwMwM
"}
