"a" = (/turf/unsimulated/mineral,/area/ghost_arena)
"d" = (/obj/effect/landmark/ghost_arena_spawn,/turf/unsimulated/beach/sand,/area/ghost_arena)
"e" = (/obj/structure/railing/steel{dir = 8},/turf/unsimulated/floor/rescue_base,/area/ghost_arena)
"f" = (/obj/structure/railing/steel{dir = 1},/turf/unsimulated/floor/rescue_base,/area/ghost_arena)
"g" = (/obj/effect/landmark/ghost_arena_spawn/security,/turf/unsimulated/floor/rescue_base,/area/ghost_arena)
"i" = (/obj/effect/landmark/ghost_arena_spawn/greytide,/turf/unsimulated/floor/rescue_base,/area/ghost_arena)
"n" = (/turf/simulated/floor/water/fountain,/area/ghost_arena)
"o" = (/turf/unsimulated/floor,/area/ghost_arena)
"q" = (/turf/unsimulated/floor/rescue_base,/area/ghost_arena)
"s" = (/turf/simulated/floor/trim/wood,/area/ghost_arena)
"u" = (/obj/structure/railing/steel,/turf/unsimulated/floor/rescue_base,/area/ghost_arena)
"y" = (/turf/simulated/floor/trim/wood/broken6,/area/ghost_arena)
"z" = (/obj/structure/window_frame/rglass,/turf/simulated/floor/trim/wood,/area/ghost_arena)
"A" = (/turf/unsimulated/beach/sand,/area/ghost_arena)
"C" = (/obj/effect/floor_decal/jungledirt/grass,/turf/unsimulated/floor/rescue_base,/area/ghost_arena)
"D" = (/turf/simulated/floor/trim/wood/broken0,/area/ghost_arena)
"G" = (/obj/structure/railing/steel{dir = 4},/turf/unsimulated/floor,/area/ghost_arena)
"J" = (/obj/machinery/door/unpowered/simple/wood,/turf/simulated/floor/trim/wood,/area/ghost_arena)
"L" = (/obj/item/storage/toolbox,/turf/simulated/wall/gold,/area/ghost_arena)
"M" = (/turf/unsimulated/wall,/area/ghost_arena)
"N" = (/obj/effect/landmark/ghost_arena_spawn,/turf/unsimulated/floor/rescue_base,/area/ghost_arena)
"P" = (/obj/effect/landmark/ghost_arena_spawn,/obj/structure/railing/steel{dir = 1},/turf/unsimulated/floor/rescue_base,/area/ghost_arena)
"S" = (/turf/simulated/floor/trim/wood/broken2,/area/ghost_arena)
"V" = (/obj/effect/landmark/ghost_arena_spawn,/turf/simulated/floor/trim/wood,/area/ghost_arena)
"Z" = (/obj/effect/landmark/ghost_arena_spawn,/turf/unsimulated/floor,/area/ghost_arena)

(1,1,1) = {"
MMMMMMMMMMMMMMMMMMMMMMMMMMMMMMMMMMMMMMMMMMMMMM
MaaaaaaaaaaaaaMqqqqqqMssMaaaaaMMqqqMaaaaaaaaaM
MaaaaaaaaaaaaaMqqqqqqJssMaaaaaMqqqqMaaaaaaaaaM
MaaaaaaaaaaaaaMMqNMMMMssMMMMMMMqqqqMaaaaaaaaaM
MaaaaaaaaaaaaaaMqqMsssssssVsssMqNqqMaaaaaaaaaM
MaaaaaaaMMMMMMMMqqMsssssssssssMqqqqMaaaaaaaaaM
MaaaaaaaMooMMMqqqqMMMMssMMJMMMMqqqqMMMMMaaaaaM
MaaaaaaaMooMMouuuqqqqMssMqqqqqqqqqqqqqqMaaaaaM
MaaaaaaaMoZMMGnnneqqqMMMMqqqqqqqqqqqqqqMMMaaaM
MaaaaaaaMooooGnLneqqqqqqqqqqqqqqqqqqqqqqqMaaaM
MaaaaaaaMoMooGnnneqqqqqqqqqqqqqqMqqqqqqqqMMMMM
MaaaaaaaMoMoooPffqqqqCCCCCMMMMMMMqqqqqqqqqqqMM
MaaaaaaaMoooooqqqqqqqMMMMMMaaaaaMqqqqqqqqqqqMM
MaaaaaaaMMMMMMMMMMMqqMaaaaaaaaaaMqqqqqqqqqqqMa
MaaaaaaaaaaaaMNqqqqqqMaaaaaaaaaaMqqqqqqqqqqqMM
MaaaaaaaaaaaaMqqqqqqqMaaaaaaaaaaMqqMMMMMgggMMM
MaaaaaaaaaaaaMqqqqqqqMaaaaaaaaaaMqqMaaaMgggMaM
MaaaaaaaaaaaaMqqqMMMMMaaaaaaaaaaMqNMMMMMgggMMM
MaaaaaaaaaaaaMqqqMaaaaaaaaaaaaaaMqqqqqqqqqqqMM
MaaaaaaaaaaaMMqqMMaaaaaaaaaaaaaaMqqqqqqqqqqqMM
MaaaaaaaaaaaMqqqMaaaaaaaaaaaaaaaMqqqqqqqqqqqMM
MaaaaaaaaaaaMqqMaaaaaaaaaaaaaaaaMMMMqqMMMMJMMM
MaaaaaaaaaaaMqqMaaaaaaaaaaaaaaaaaaaMqqMssssssM
MaaaaaaaaaMMMqqMaaaaaaaaaaaaaaaaaaaMqqMssssssM
MaaaaaaaaaMqqqqMaaaaaaMMMMMMMaaaMMMMqqMMMMMsVM
MaaaaaaaaaMqqqqMaaaaaaMNqqqNMaaaMqqqqqqqqqJssM
MaaaaMMMMMMMMqqMaaaaaaMqqqqqMaaaMqqqqqqqqqMssM
MaaaaMqqqqqqqqqMMMMMMMMqqqqqMMMMMMqqMMMMqqMssM
MaMMMMqqqqqqqqqqqqqqqqqqqqqqqqqqqqqqMMMMqqMMMM
MaMqqqqqqMMMMqqqqqqqqqqqqqqqqqqqqqqqMoMMqqAAMM
MaMqNqqqqMSszqqqqqqqqqqqqqqqqqqqqqqqMoooqqAAMM
MMMqqqqqqMssMMMMMMMMMMMMqqqMMMMMMMqqMoooqqMMMM
MMqqqqqMMMJMMsssMMMMMMMMqqqMooMsssqqMZooqqMaaM
MMqqqqqMDsssMsMsMsMMMMMMqqqMMMMssMqqMoooqqMaaM
MMqNqMqJssssJSMsVssMMMMqqqqMssJssMqqMoooqqMMMM
MMqqqMMMsVssMsMssssMMMMqqqqMssMssMqqMoooqqAAAM
MMqqqqqMysssMMMqqqqqqqqqqqqzssMssMqqMoooqqAAAM
MMqqqqqMMzzMMqqqqqqqqqNqqqqJsVMssMqqqqqqqqAAAM
MMMMqqqqqqqqqqqqqqqqqqqqqqqzssMssMqqqqqqqqAAAM
MiiqqqqqqqqqqqqqqqqqqqqqqqqMssMssMqqqqqqqqAAAM
MiiMqqMMMJJMqqqqqqqqqqqqqqqMMMMssMMzzMMJMMAAAM
MiiqqqzsssssMMMMMMMJMMMMqqqMMMsssVsssssssMAAAM
MiiMqqMssVssMsssVMMsMsVMqqqMMMsssssssssssMAAAM
MiiqqqzsssssssssssssJssMqqqMssssMMMMMMMMMMAAdM
MMMMqqMsssssMMMsssssMssJqqqJssssMaaaaaaaMAAAAM
MMMMMMMMMMMMMMMMMMMMMMMMMMMMMMMMMMMMMMMMMMMMMM
"}
