"af" = (/obj/item/frame/air_alarm{dir = 8; pixel_x = 29},/obj/item/remains/human,/turf/simulated/floor/plating,/area/space)
"aL" = (/obj/structure/cable{d1 = 1; d2 = 2; icon_state = "1-2"},/turf/simulated/floor/plating{icon_state = "dmg1"},/area/space)
"aV" = (/obj/item/circuitboard/broken,/turf/simulated/floor/plating,/area/space)
"bv" = (/obj/effect/decal/cleanable/generic,/turf/simulated/floor/plating{icon_state = "dmg1"},/area/space)
"cn" = (/obj/effect/decal/cleanable/dirt,/obj/item/frame/air_alarm{pixel_y = 31},/obj/structure/table,/obj/effect/decal/cleanable/molten_item,/turf/simulated/floor/plating,/area/space)
"cw" = (/turf/simulated/floor/asteroid,/area/space)
"cR" = (/obj/item/remains/human,/obj/effect/decal/cleanable/ash,/turf/simulated/floor/plating{icon_state = "dmg1"},/area/space)
"dr" = (/obj/item/stack/cable_coil{amount = 1},/turf/simulated/floor/asteroid,/area/space)
"ej" = (/obj/effect/decal/cleanable/dirt,/turf/simulated/wall,/area/space)
"eU" = (/obj/effect/decal/cleanable/dirt,/obj/item/stack/cable_coil{amount = 1},/turf/simulated/floor/plating,/area/space)
"fa" = (/obj/effect/decal/cleanable/dirt,/obj/structure/disposalpipe/segment{dir = 4},/turf/simulated/floor/plating,/area/space)
"fk" = (/obj/item/stack/cable_coil{amount = 1},/turf/simulated/floor/plating{icon_state = "dmg1"},/area/space)
"go" = (/obj/structure/table,/obj/effect/decal/cleanable/molten_item,/turf/simulated/floor/plating,/area/space)
"gy" = (/obj/effect/decal/cleanable/generic,/turf/simulated/floor/asteroid,/area/space)
"gB" = (/obj/effect/decal/cleanable/dirt,/obj/structure/disposalpipe/segment{dir = 2},/obj/structure/door_assembly,/turf/simulated/floor/plating,/area/space)
"gN" = (/obj/effect/decal/cleanable/dirt,/obj/structure/disposalpipe/segment{dir = 2},/turf/simulated/floor/plating{icon_state = "dmg1"},/area/space)
"gW" = (/obj/effect/decal/cleanable/dirt,/turf/simulated/floor/plating{icon_state = "dmg1"},/area/space)
"hj" = (/obj/effect/decal/cleanable/dirt,/obj/structure/cable{d1 = 2; d2 = 4; icon_state = "2-4"},/turf/simulated/floor/plating,/area/space)
"hE" = (/obj/effect/decal/cleanable/molten_item,/turf/simulated/floor/plating{icon_state = "dmg2"},/area/space)
"im" = (/obj/structure/window_frame/broken,/turf/simulated/floor/plating{icon_state = "dmg1"},/area/space)
"iS" = (/obj/machinery/constructable_frame,/turf/simulated/floor/plating,/area/space)
"jr" = (/obj/effect/decal/cleanable/dirt,/obj/structure/disposalpipe/segment{dir = 4},/obj/effect/decal/cleanable/ash,/turf/simulated/floor/plating,/area/space)
"jX" = (/obj/structure/cable,/turf/simulated/floor/plating,/area/space)
"kp" = (/obj/structure/girder,/obj/effect/landmark/map_data{height = 4},/turf/simulated/floor/plating,/area/space)
"kw" = (/obj/item/frame/light{dir = 4; pixel_x = 14},/turf/simulated/floor/plating,/area/space)
"ky" = (/obj/effect/decal/cleanable/dirt,/obj/effect/decal/cleanable/dirt,/obj/structure/disposalpipe/segment{dir = 4},/turf/simulated/floor/plating,/area/space)
"lj" = (/obj/structure/cable{d1 = 1; d2 = 2; icon_state = "1-2"},/obj/effect/decal/cleanable/molten_item,/turf/simulated/floor/plating,/area/space)
"ln" = (/obj/item/frame{pixel_y = 28},/obj/structure/table,/turf/simulated/floor/plating,/area/space)
"lp" = (/obj/effect/decal/cleanable/dirt,/obj/structure/door_assembly,/turf/simulated/floor/plating,/area/space)
"lt" = (/obj/effect/decal/cleanable/dirt,/obj/structure/cable{d1 = 2; d2 = 8; icon_state = "2-8"},/turf/simulated/floor/plating,/area/space)
"lE" = (/obj/effect/decal/cleanable/dirt,/turf/simulated/floor/asteroid,/area/space)
"lK" = (/obj/effect/decal/cleanable/dirt,/obj/item/frame/light{dir = 8; pixel_x = -15},/obj/structure/disposalpipe/segment{dir = 2},/turf/simulated/floor/plating,/area/space)
"lO" = (/obj/effect/decal/cleanable/generic,/turf/simulated/floor/plating,/area/space)
"ma" = (/obj/effect/decal/cleanable/dirt,/obj/structure/cable{d1 = 1; d2 = 8; icon_state = "1-8"},/obj/structure/disposalpipe/broken{dir = 1},/turf/simulated/floor/plating,/area/space)
"mk" = (/obj/effect/decal/cleanable/dirt,/obj/structure/cable{d1 = 1; d2 = 2; icon_state = "1-2"},/obj/structure/disposalpipe/segment{dir = 2},/turf/simulated/floor/plating,/area/space)
"my" = (/obj/effect/decal/cleanable/dirt,/obj/effect/decal/cleanable/generic,/turf/simulated/floor/plating,/area/space)
"nm" = (/obj/item/remains/human,/turf/simulated/floor/plating{icon_state = "dmg1"},/area/space)
"nv" = (/obj/structure/disposalpipe/broken{dir = 1},/turf/simulated/floor/plating{icon_state = "dmg1"},/area/space)
"nR" = (/obj/item/frame/light{dir = 4; pixel_x = 14},/turf/simulated/mineral,/area/space)
"nS" = (/obj/structure/disposalpipe/segment{dir = 2},/turf/simulated/floor/plating,/area/space)
"ol" = (/obj/structure/disposalpipe/sortjunction{dir = 8},/turf/simulated/floor/asteroid,/area/space)
"ot" = (/obj/structure/cable{d1 = 1; d2 = 2; icon_state = "1-2"},/obj/structure/cable{d1 = 2; d2 = 4; icon_state = "2-4"},/obj/structure/disposalpipe/segment{dir = 2},/turf/simulated/floor/plating,/area/space)
"oY" = (/obj/structure/cable{d1 = 1; d2 = 2; icon_state = "1-2"},/obj/structure/door_assembly,/turf/simulated/floor/plating,/area/space)
"pc" = (/obj/effect/decal/cleanable/dirt,/turf/simulated/floor/plating{icon_state = "dmg4"},/area/space)
"pd" = (/obj/item/frame/light{dir = 8; pixel_x = -15},/turf/simulated/floor/plating,/area/space)
"py" = (/obj/structure/closet,/turf/simulated/floor/plating{icon_state = "dmg1"},/area/space)
"pA" = (/obj/effect/decal/cleanable/dirt,/obj/item/frame/light{dir = 4; pixel_x = 14},/turf/simulated/floor/plating,/area/space)
"pP" = (/obj/structure/cable{d2 = 2; icon_state = "0-2"; pixel_y = 1},/turf/simulated/floor/plating,/area/space)
"qk" = (/turf/simulated/floor/plating{icon_state = "dmg3"},/area/space)
"ql" = (/obj/item/remains/human,/turf/simulated/floor/plating,/area/space)
"qB" = (/obj/structure/disposalpipe/sortjunction{dir = 8},/turf/simulated/floor/plating{icon_state = "dmg1"},/area/space)
"qN" = (/obj/structure/closet,/obj/item/clothing/suit/justice,/turf/simulated/floor/plating,/area/space)
"rz" = (/obj/structure/disposalpipe/segment{dir = 4; icon_state = "pipe-c"},/turf/simulated/floor/plating{icon_state = "dmg1"},/area/space)
"sm" = (/obj/structure/disposalpipe/broken,/turf/simulated/floor/plating,/area/space)
"su" = (/obj/effect/decal/cleanable/dirt,/obj/effect/decal/cleanable/ash,/turf/simulated/floor/plating,/area/space)
"sA" = (/obj/item/frame/air_alarm{dir = 8; pixel_x = 29},/turf/simulated/floor/plating,/area/space)
"tt" = (/obj/item/frame{pixel_y = 28},/obj/structure/cable{d2 = 2; icon_state = "0-2"},/turf/simulated/floor/plating,/area/space)
"tQ" = (/obj/effect/decal/cleanable/dirt,/obj/structure/cable{d1 = 1; d2 = 4; icon_state = "1-4"},/turf/simulated/floor/plating,/area/space)
"tW" = (/obj/item/frame/light{dir = 8; pixel_x = -15},/obj/structure/cable{d1 = 1; d2 = 2; icon_state = "1-2"},/turf/simulated/floor/plating,/area/space)
"uC" = (/obj/effect/decal/cleanable/dirt,/obj/effect/decal/cleanable/blood/gibs/robot,/turf/simulated/floor/plating,/area/space)
"uE" = (/turf/simulated/open,/area/space)
"uZ" = (/obj/effect/decal/cleanable/dirt,/obj/structure/disposalpipe/segment{dir = 4},/turf/simulated/floor/asteroid,/area/space)
"vi" = (/turf/simulated/mineral,/area/space)
"vj" = (/obj/effect/decal/cleanable/dirt,/obj/effect/decal/cleanable/dirt,/turf/simulated/floor/plating{icon_state = "dmg1"},/area/space)
"vC" = (/obj/item/frame/air_alarm{pixel_y = 31},/obj/structure/closet,/turf/simulated/floor/plating,/area/space)
"vN" = (/obj/item/frame{pixel_y = 28},/obj/item/frame/light{dir = 1; pixel_y = 15},/obj/structure/disposalpipe/trunk,/turf/simulated/floor/plating,/area/space)
"wa" = (/obj/effect/decal/cleanable/dirt,/obj/structure/cable{icon_state = "2-8"},/obj/structure/cable{d1 = 1; d2 = 8; icon_state = "1-8"},/turf/simulated/floor/plating,/area/space)
"wb" = (/obj/effect/decal/cleanable/dirt,/obj/item/frame/light{dir = 8; pixel_x = -15},/turf/simulated/floor/plating,/area/space)
"wt" = (/obj/effect/decal/cleanable/dirt,/obj/structure/disposalpipe/segment{dir = 4},/turf/simulated/floor/plating{icon_state = "dmg1"},/area/space)
"xA" = (/obj/effect/decal/cleanable/dirt,/obj/structure/cable{d1 = 1; d2 = 2; icon_state = "1-2"},/turf/simulated/floor/plating,/area/space)
"xF" = (/obj/structure/disposalpipe/segment{dir = 8; icon_state = "pipe-c"},/turf/simulated/floor/plating,/area/space)
"yp" = (/obj/effect/decal/cleanable/dirt,/obj/effect/decal/cleanable/greenglow,/turf/simulated/floor/plating,/area/space)
"yO" = (/obj/structure/cable{d1 = 2; d2 = 4; icon_state = "2-4"},/turf/simulated/floor/plating,/area/space)
"yR" = (/obj/item/frame/light{dir = 8; pixel_x = -15},/obj/structure/stairs/north,/turf/simulated/floor/plating,/area/space)
"zz" = (/obj/effect/decal/cleanable/molten_item,/turf/simulated/floor/plating{icon_state = "dmg1"},/area/space)
"AD" = (/obj/effect/decal/cleanable/dirt,/obj/structure/cable{d1 = 1; d2 = 2; icon_state = "1-2"},/obj/structure/disposalpipe/broken{dir = 4},/turf/simulated/floor/plating,/area/space)
"BG" = (/obj/structure/disposalpipe/broken{dir = 8},/obj/structure/door_assembly,/turf/simulated/floor/plating,/area/space)
"BM" = (/obj/effect/decal/cleanable/dirt,/obj/effect/decal/cleanable/molten_item,/turf/simulated/floor/plating{icon_state = "dmg1"},/area/space)
"BX" = (/obj/structure/cable{d1 = 1; d2 = 2; icon_state = "1-2"},/turf/simulated/floor/plating,/area/space)
"Cn" = (/obj/item/frame/light{pixel_y = -13},/obj/structure/cable{d1 = 4; d2 = 8; icon_state = "4-8"},/turf/simulated/floor/plating,/area/space)
"Cq" = (/obj/structure/cable{d2 = 2; icon_state = "0-2"},/turf/simulated/floor/plating,/area/space)
"CF" = (/obj/effect/decal/cleanable/dirt,/obj/structure/table,/turf/simulated/floor/plating,/area/space)
"Dq" = (/obj/effect/decal/cleanable/dirt,/obj/structure/window_frame,/obj/structure/window_frame/broken,/turf/simulated/floor/plating,/area/space)
"DB" = (/obj/effect/decal/cleanable/molten_item,/turf/simulated/floor/plating{icon_state = "dmg3"},/area/space)
"Es" = (/obj/effect/decal/cleanable/dirt,/obj/item/clothing/head/helmet/space,/turf/simulated/floor/plating,/area/space)
"Ez" = (/obj/effect/decal/cleanable/dirt,/obj/structure/cable{d1 = 1; d2 = 8; icon_state = "1-8"},/obj/structure/disposalpipe/segment{dir = 4; icon_state = "pipe-c"},/turf/simulated/floor/plating,/area/space)
"EO" = (/obj/structure/table,/obj/item/circuitboard/broken,/turf/simulated/floor/plating,/area/space)
"Fv" = (/obj/structure/cable{d1 = 4; d2 = 8; icon_state = "4-8"},/turf/simulated/floor/plating,/area/space)
"FH" = (/obj/structure/window_frame/broken,/obj/effect/decal/cleanable/molten_item,/turf/simulated/floor/plating,/area/space)
"FW" = (/obj/effect/decal/cleanable/dirt,/obj/item/frame/light{dir = 8; pixel_x = -15},/turf/simulated/floor/plating{icon_state = "dmg1"},/area/space)
"Ge" = (/obj/structure/table,/turf/simulated/floor/plating,/area/space)
"Gn" = (/obj/effect/decal/cleanable/dirt,/obj/structure/cable{d1 = 1; d2 = 2; icon_state = "1-2"},/obj/structure/disposalpipe/broken{dir = 8},/turf/simulated/floor/plating,/area/space)
"Gu" = (/obj/structure/cable{d1 = 1; d2 = 8; icon_state = "1-8"},/obj/effect/decal/cleanable/molten_item,/turf/simulated/floor/plating,/area/space)
"Hc" = (/obj/effect/decal/cleanable/dirt,/obj/effect/decal/cleanable/dirt,/turf/simulated/floor/plating,/area/space)
"HF" = (/obj/structure/grille/broken,/turf/simulated/floor/plating,/area/space)
"HI" = (/obj/effect/decal/cleanable/dirt,/obj/effect/decal/cleanable/molten_item,/turf/simulated/floor/plating,/area/space)
"Ik" = (/obj/effect/decal/cleanable/dirt,/turf/simulated/floor/plating,/area/space)
"Is" = (/obj/item/frame{pixel_y = 28},/turf/simulated/floor/plating,/area/space)
"IM" = (/obj/item/frame/light{dir = 8; pixel_x = -15},/obj/machinery/vending_frame,/turf/simulated/floor/plating,/area/space)
"Jr" = (/obj/item/frame/light{dir = 1; pixel_y = 15},/obj/structure/table,/obj/item/broken_bottle,/turf/simulated/floor/plating,/area/space)
"Ju" = (/obj/effect/decal/cleanable/dirt,/obj/item/frame/light{pixel_y = -13},/obj/structure/cable{d1 = 4; d2 = 8; icon_state = "4-8"},/turf/simulated/floor/plating,/area/space)
"Jz" = (/obj/structure/cable{d2 = 8; icon_state = "0-8"},/turf/simulated/floor/plating,/area/space)
"JB" = (/obj/item/frame/air_alarm{dir = 8; pixel_x = 32},/turf/simulated/floor/plating,/area/space)
"JQ" = (/obj/effect/decal/cleanable/dirt,/obj/structure/cable{d1 = 1; d2 = 2; icon_state = "1-2"},/obj/structure/disposalpipe/broken,/turf/simulated/floor/plating,/area/space)
"Ka" = (/obj/effect/decal/cleanable/dirt,/obj/structure/cable{d1 = 4; d2 = 8; icon_state = "4-8"},/obj/structure/cable{d1 = 1; d2 = 8; icon_state = "1-8"},/turf/simulated/floor/plating,/area/space)
"Kh" = (/obj/effect/decal/cleanable/dirt,/obj/effect/decal/cleanable/dirt,/turf/simulated/floor/asteroid,/area/space)
"KJ" = (/turf/simulated/floor/plating{icon_state = "dmg1"},/area/space)
"KM" = (/obj/item/frame/light{pixel_y = -13},/turf/simulated/floor/plating{icon_state = "dmg1"},/area/space)
"KW" = (/obj/item/frame/air_alarm{pixel_y = 31},/turf/simulated/floor/plating,/area/space)
"Ln" = (/obj/effect/decal/cleanable/dirt,/obj/structure/cable{d1 = 4; d2 = 8; icon_state = "4-8"},/turf/simulated/floor/plating,/area/space)
"Lu" = (/obj/effect/decal/cleanable/dirt,/obj/structure/cable{d2 = 4; icon_state = "0-4"},/turf/simulated/floor/plating,/area/space)
"Mc" = (/obj/structure/window_frame/broken,/turf/simulated/floor/plating,/area/space)
"MD" = (/obj/structure/disposalpipe/sortjunction{dir = 1},/turf/simulated/floor/plating{icon_state = "dmg1"},/area/space)
"ME" = (/obj/structure/computerframe,/turf/simulated/floor/plating,/area/space)
"MF" = (/obj/effect/decal/cleanable/dirt,/turf/simulated/mineral,/area/space)
"Nf" = (/obj/item/frame/light{pixel_y = -13},/turf/simulated/floor/plating,/area/space)
"Ng" = (/obj/structure/disposalpipe/sortjunction{dir = 8},/obj/effect/decal/cleanable/dirt,/turf/simulated/floor/plating{icon_state = "dmg1"},/area/space)
"Nk" = (/obj/structure/door_assembly,/turf/simulated/floor/plating{icon_state = "dmg1"},/area/space)
"NF" = (/obj/structure/disposalpipe/trunk{dir = 8},/turf/simulated/floor/plating,/area/space)
"Oh" = (/obj/item/circuitboard/broken,/turf/simulated/floor/plating{icon_state = "dmg1"},/area/space)
"OW" = (/obj/effect/decal/cleanable/dirt,/obj/item/frame/air_alarm{dir = 8; pixel_x = 29},/turf/simulated/floor/asteroid,/area/space)
"Pn" = (/obj/effect/decal/cleanable/dirt,/obj/structure/disposalpipe/broken,/turf/simulated/floor/plating{icon_state = "dmg1"},/area/space)
"Qe" = (/obj/effect/decal/cleanable/dirt,/obj/effect/decal/cleanable/dirt,/obj/structure/disposalpipe/segment{dir = 4},/turf/simulated/floor/asteroid,/area/space)
"Qs" = (/turf/simulated/wall,/area/space)
"QM" = (/obj/structure/girder,/obj/effect/decal/cleanable/dirt,/turf/simulated/floor/plating,/area/space)
"Rl" = (/obj/effect/decal/cleanable/dirt,/obj/structure/disposalpipe/segment{dir = 4; icon_state = "pipe-c"},/turf/simulated/floor/plating{icon_state = "dmg1"},/area/space)
"Rt" = (/turf/unsimulated/mineral,/area/space)
"Rx" = (/obj/structure/window_frame,/turf/simulated/floor/plating,/area/space)
"RC" = (/obj/effect/decal/cleanable/dirt,/obj/structure/disposalpipe/segment{dir = 8; icon_state = "pipe-c"},/turf/simulated/floor/plating,/area/space)
"RG" = (/obj/effect/decal/cleanable/ash,/turf/simulated/floor/plating{icon_state = "dmg3"},/area/space)
"RX" = (/obj/effect/decal/cleanable/dirt,/obj/item/frame/light{dir = 1; pixel_y = 15},/turf/simulated/floor/plating,/area/space)
"SL" = (/obj/structure/door_assembly,/turf/simulated/floor/plating,/area/space)
"SX" = (/obj/item/frame/light{dir = 1; pixel_y = 15},/turf/simulated/floor/plating,/area/space)
"Tf" = (/obj/effect/decal/cleanable/dirt,/obj/structure/disposalpipe/broken,/obj/effect/decal/cleanable/ash,/turf/simulated/floor/plating,/area/space)
"Tj" = (/obj/item/frame/light{dir = 8; pixel_x = -15},/obj/structure/cable{d1 = 2; d2 = 4; icon_state = "2-4"},/turf/simulated/floor/plating,/area/space)
"Tm" = (/obj/structure/disposalpipe/segment{dir = 4},/turf/simulated/floor/plating,/area/space)
"Tu" = (/obj/structure/disposalpipe/segment{dir = 4},/turf/simulated/floor/plating{icon_state = "dmg1"},/area/space)
"Tw" = (/obj/machinery/vending_frame,/turf/simulated/floor/plating,/area/space)
"TE" = (/obj/structure/girder,/turf/simulated/floor/plating{icon_state = "dmg1"},/area/space)
"TO" = (/obj/structure/cable{d2 = 4; icon_state = "0-4"},/obj/effect/decal/cleanable/molten_item,/turf/simulated/floor/plating,/area/space)
"TW" = (/obj/effect/decal/cleanable/molten_item,/turf/simulated/floor/plating,/area/space)
"Ua" = (/obj/effect/decal/cleanable/dirt,/obj/effect/decal/cleanable/dirt,/obj/item/frame{pixel_y = 28},/turf/simulated/floor/plating,/area/space)
"Uh" = (/obj/effect/decal/cleanable/dirt,/obj/structure/stairs/north,/turf/simulated/floor/plating,/area/space)
"Up" = (/obj/structure/cable{d1 = 4; d2 = 8; icon_state = "4-8"},/obj/structure/door_assembly,/turf/simulated/floor/plating,/area/space)
"Ur" = (/obj/effect/decal/cleanable/dirt,/obj/effect/decal/cleanable/dirt,/obj/structure/disposalpipe/segment{dir = 2},/turf/simulated/floor/plating{icon_state = "dmg1"},/area/space)
"Us" = (/obj/effect/decal/cleanable/dirt,/obj/structure/disposalpipe/segment{dir = 2},/turf/simulated/floor/plating,/area/space)
"Ux" = (/turf/simulated/floor/plating{icon_state = "dmg2"},/area/space)
"UN" = (/obj/structure/girder,/turf/simulated/floor/plating,/area/space)
"Vc" = (/obj/effect/decal/cleanable/greenglow,/turf/simulated/floor/plating{icon_state = "dmg1"},/area/space)
"Vv" = (/obj/effect/decal/cleanable/ash,/turf/simulated/floor/plating{icon_state = "dmg1"},/area/space)
"Vw" = (/obj/structure/disposalpipe/broken{dir = 1},/turf/simulated/floor/plating,/area/space)
"VF" = (/obj/effect/decal/cleanable/ash,/turf/simulated/floor/plating,/area/space)
"Wa" = (/obj/effect/decal/cleanable/dirt,/obj/structure/cable{d1 = 1; d2 = 2; icon_state = "1-2"},/obj/effect/decal/cleanable/ash,/turf/simulated/floor/plating,/area/space)
"Wy" = (/obj/effect/decal/cleanable/dirt,/obj/effect/decal/cleanable/dirt,/obj/structure/disposalpipe/segment{dir = 4; icon_state = "pipe-c"},/turf/simulated/floor/plating{icon_state = "dmg1"},/area/space)
"WC" = (/obj/structure/cable{d2 = 4; icon_state = "0-4"},/turf/simulated/floor/plating,/area/space)
"WR" = (/obj/effect/decal/cleanable/dirt,/obj/structure/window_frame,/turf/simulated/floor/plating,/area/space)
"Xn" = (/turf/simulated/floor/plating,/area/space)
"XE" = (/obj/effect/decal/cleanable/dirt,/obj/effect/decal/cleanable/dirt,/obj/structure/computerframe,/turf/simulated/floor/plating{icon_state = "dmg1"},/area/space)
"XU" = (/obj/item/frame/light{dir = 8; pixel_x = -15},/obj/structure/cable{d2 = 2; icon_state = "0-2"; pixel_y = 1},/turf/simulated/floor/plating,/area/space)
"XY" = (/obj/effect/decal/cleanable/dirt,/obj/item/circuitboard/broken,/turf/simulated/floor/plating,/area/space)
"Zo" = (/obj/effect/decal/cleanable/dirt,/obj/item/circuitboard/broken,/turf/simulated/floor/asteroid,/area/space)
"Zy" = (/obj/structure/cable{d1 = 4; d2 = 8; icon_state = "4-8"},/turf/simulated/floor/plating{icon_state = "dmg1"},/area/space)

(1,1,1) = {"
RtRtRtRtRtRtRtRtRtRtRtRtRtRtRtRtRtRtRtRtRtRtRtRtRtRtRtRtRtRtRtRtRtRtRtRtRtRtRtRt
RtviviviviviviviviQsQsQsQsQsQsQsQsQsQsQsQsQsQsQsXnXnXnviviviviviviviviviviviviRt
RtQsQsQsQsQsQsQsQsQsGeGeXnCqQsyRUhUhQsIsXnGeMEQsXnXnXnXnviviQsviviviviviviviviRt
RtQsGeGeQsXnSXXnXnQsXnyOFvGuQsXnHcIkQspdIkIkIkQsXnXnXnXnXnviQsvicwviviviviviviRt
RtQsVFXnXnXnVFlOXnQsXnljVFiSQsXnHcsuQsTOltXnXnQspdXnXnXnXnXnQsXncwcwviviviviviRt
RtQsXnXnQsXnXnXnXnQsMEBXXniSQspdhjJzQspdxAXnXnQsQsQsQsQsQsQsQsXnXnXnviviviviviRt
RtQspdXnQsQsQsQsQsQsQsBXQsQsQsXnaLXnQsQsoYQsQsQsXnXnTWIsXnXnQsXnIkIkXnXnXnXnviRt
RtQsqlXnQsXnSXXnsAQsXnWaHcUaIkIkxAIkXnTWBXXnTwQsXnbvXnnmXnXnQsXnXnXnXnIkIkXnviRt
RtQsXnVFXnlOXnlOVFQsXnJQIkIkIkIkADfakykyGnXnKJQsXnTWXnXnXnJBQsXnXnQsXnIkIkXnviRt
RtQsXnXnQsXnXnXnXnQsXnotFvFvCnZyKaFvJuLnwaTfXnQspdXnbvXnzzXnQssmXnQsQsQsXnIkIkRt
RtQsQsXnQsQsQsQsQsQsIkmkpAQsejDqWRRxQsQsBXUsXnQsKJXnXnXnXnXnQsUsIkXnXnXnXnIkIkRt
RtQsaVXnTwTwQsJrlnQsIkmkIkQscnXEHcVFttQstWnSIkQsMcFHQsSLQsQsQsnSXnXnIkIkcwcwXnRt
RtQsXngWeULuLnLnLnZyLnmaIkWRIkIkIkVvtQLnEzNgfaTmfajrfaTmTmfafaxFQsXnsuIkcwcwXnRt
RtQspdrzkyfafafafaBGIkIkKJXnXngWHcgWKJDqUrHcIkSLIkIkIkKJXnHcIkXnXnXnXnXnIkIkIkRt
RtQsXnnvXnXnQsKMKJQsgWvjbvQsiSIkWyTuNFQsUsIkKJQsejejejXnlOIkXnkwQsXnXncwlElEIkRt
RtQsQsXnQsQsQsQsQsQsIkuCkwQsTEWRgBimQsQslKEsXnQsTwIscwcwcwcwXnXnKJIkHcXnXnXnXnRt
RtQsXnXnQspyKJXnXnQsIkvjXnSXXnHcUsXnXnSXMDfaNFQsIMXnlEcwcwcwQsQsKJIkIkvivivicwRt
RtQslOpPXnKJKJXnXnQsXnRlfakywtfaqBfawtfaRCgWXnQsCFTWlEcwcwcwXnXnKJIkIkcwvivicwRt
RtQsIkBXQsXnXnXnXnQswbVwXnNfIkIkXnXnXnNfXnIkGeQsEOVFXnTWIkIklEcwKJXnQscwvicwcwRt
RtQsXYBXQsQsQsQsQsQsQssmimQsUNUNkpQsUNQsMcgWQsQsQsQsQsQsIkHcKhlEHFkwQscwcwcwcwRt
RtQspdjXQsqNTWXnXnQsgWUsXnVFXnKJKJXnXnXnXnIkVFXnQsXnXnKWcwIkIkIkHFXnQscwcwcwcwRt
RtQsXnWCUpJzlOXnXnQsHIgNKJXnqkqkUxUxXnVcbvcRKJXnKJXnIkKJgyXnaVkwQsXnQscwcwcwcwRt
RtvigWIkQsXnXnXnVFUNKJnvKJUxqkuEuEuEUxXnqkVFOhXnQsXnKJgWlEIkXnXnQsXncwcwcwviviRt
RtviMFIkQsQsQsQsQsQsKJKJTWUxuEuEuEuEuEUNUNUNNkQsQsQsKJIkIkIkXnKJQsXncwcwcwviviRt
RtviviXnQsvCXnXnXnUNKJTWXnuEuEuEuEuEuEuEqkXnKJXnXnQsTjviviKJKJKJQsXncwcwviviviRt
RtQsviKJSLXnKJbvVFUNqkUxuEuEuEuEuEuEuEuEuEqkzzKJUxQsaLvivivivinRQsXnXnXnviviviRt
RtQsBMbvQsTWzzKJXnQsIkuEuEuEuEuEuEuEuEuEuEuEqkzzXnQsjXviviviQsejejQsXnviviviviRt
RtQsFWKJQsQsQsQsQsUNIkuEuEuEuEuEuEuEuEuEuEuEUNKJUxUNKJcwviviviMFIkXncwvivicwviRt
RtQsGegoQsXnSXXnQsKJpcuEuEuEuEuEuEuEuEuEuEuEUxKJXnUNfkKJcwviviviXnKJcwcwcwcwviRt
RtQsQsQsQsIkHImylpKJgWhEuEuEuEuEuEuEuEuEuEqkDBKJKJQsXUKJcwcwcwcwXnKJlOXncwcwcwRt
RtXnSXXnXnlEgWXnKJKJKJKJqkuEuEuEuEuEuEuEUxUxKJDBXnQsBXcwcwvicwcwkwQsXnXncwcwcwRt
RtlElElEXnIkIkXnQsQslpQMUNUNuEuEuEuEuEUNKJKJqkKJKJQsBXcwdrvicwcwviQsIkIkcwcwcwRt
RtcwcwcwcwlElEXnQsXngWsuQszzUxuEuEuEUxUNzzXnQsQsQsQsXncwvivicwcwviQsIklEcwcwcwRt
RtIkXnSLcwlEIkXnQsKJgWIkUNKJXnDBXnqkKJVvRGKJQsXnvNXnlOcwcwcwcwcwviQsIklEcwcwviRt
RtIkXnQscwcwIkIkQsXnXnKJQsKJKJvjnmKJKJUNOhXnQsIkUscwcwcwcwcwcwcwviIkXnXncwcwviRt
RtIkafQscwcwIkIkQsQsXnQsQsQsQsgWKJQsQsQsQsQsQsIkUslElElEcwvicwcwcwIkIkIkcwcwviRt
RtXnXnQsXnIklEXnIsSXXnXnviviXnPngWypHcRXIkIkXnIkUscwcwcwvivicwcwcwIklElEcwviviRt
RtcwXnQsGeIklEcwlElElEIkviviuZolwtuZQeuZuZuZTmTmxFXnXnviviviviviviXnlElEcwviviRt
RtviXnQsQsQsQsQsQsQsXnvivivivivivivivivicwlEIklEZoOWQsQsQsQsQsQsQsXnIkIkcwviviRt
RtRtRtRtRtRtRtRtRtRtRtRtRtRtRtRtRtRtRtRtRtRtRtRtRtRtRtRtRtRtRtRtRtRtRtRtRtRtRtRt
"}
