"a" = (/obj/structure/snow,/turf/unsimulated/floor/frozenground,/area/polarplanet/street)
"b" = (/obj/structure/snow,/obj/structure/snow,/obj/structure/snow,/turf/unsimulated/floor/frozenground,/area/polarplanet/street)
"d" = (/obj/structure/snow,/obj/structure/snow,/turf/simulated/floor/misc/abductor,/area/polarplanet/street)
"e" = (/turf/unsimulated/wall/abductor{icon_state = "alien24"},/area/polarplanet/street)
"f" = (/turf/unsimulated/wall/abductor{icon_state = "alien23"},/area/polarplanet/street)
"g" = (/turf/unsimulated/wall/abductor{icon_state = "alien9"},/area/polarplanet/street)
"h" = (/turf/unsimulated/wall/abductor,/area/polarplanet/street)
"i" = (/turf/unsimulated/wall/abductor{icon_state = "alien3"},/area/polarplanet/street)
"j" = (/obj/random/trash,/turf/simulated/floor/misc/abductor,/area/polarplanet/street)
"m" = (/obj/item/retractor/alien,/obj/structure/snow,/turf/simulated/floor/misc/abductor,/area/polarplanet/street)
"n" = (/obj/machinery/organ_printer/flesh/mapped,/turf/simulated/floor/misc/abductor,/area/polarplanet/street)
"o" = (/turf/unsimulated/wall/abductor{icon_state = "alien22"},/area/polarplanet/street)
"p" = (/obj/structure/table/abductor,/obj/machinery/recharger,/turf/simulated/floor/misc/abductor,/area/polarplanet/street)
"q" = (/turf/unsimulated/wall/abductor{icon_state = "alien18"},/area/polarplanet/street)
"t" = (/obj/structure/snow,/obj/structure/snow,/obj/structure/snow,/obj/structure/snow,/turf/unsimulated/floor/frozenground,/area/polarplanet/street)
"u" = (/obj/structure/table/abductor,/obj/item/surgicaldrill/alien,/obj/item/bonesetter/alien,/turf/simulated/floor/misc/abductor,/area/polarplanet/street)
"v" = (/obj/item/clothing/gloves/latex/nitrile,/obj/item/clothing/mask/surgical,/obj/structure/snow,/turf/simulated/floor/misc/abductor,/area/polarplanet/street)
"w" = (/obj/item/scalpel/alien,/obj/item/bonegel/alien,/turf/simulated/floor/misc/abductor,/area/polarplanet/street)
"x" = (/turf/unsimulated/wall/abductor{icon_state = "alien2"},/area/polarplanet/street)
"y" = (/obj/machinery/abductor/pad{team_number = 2},/turf/simulated/floor/misc/abductor,/area/polarplanet/street)
"z" = (/turf/unsimulated/wall/abductor{icon_state = "alien4"},/area/polarplanet/street)
"A" = (/obj/item/circular_saw/alien,/turf/simulated/floor/misc/abductor,/area/polarplanet/street)
"B" = (/turf/unsimulated/floor/frozenground,/area/polarplanet/street)
"C" = (/turf/unsimulated/wall/abductor{icon_state = "alien11"},/area/polarplanet/street)
"D" = (/turf/simulated/floor/misc/abductor,/area/polarplanet/street)
"E" = (/turf/unsimulated/wall/abductor{icon_state = "alien16"},/area/polarplanet/street)
"F" = (/turf/unsimulated/wall/abductor{icon_state = "alien5"},/area/polarplanet/street)
"G" = (/turf/unsimulated/wall/abductor{icon_state = "alien13"},/area/polarplanet/street)
"I" = (/obj/structure/snow,/obj/structure/snow,/turf/unsimulated/floor/frozenground,/area/polarplanet/street)
"J" = (/turf/unsimulated/wall/abductor{icon_state = "alien8"},/area/polarplanet/street)
"L" = (/obj/item/hemostat/alien,/obj/structure/snow,/turf/simulated/floor/misc/abductor,/area/polarplanet/street)
"M" = (/obj/structure/closet/abductor,/obj/item/reagent_containers/vessel/beaker/bluespace,/obj/item/reagent_containers/vessel/beaker/noreact,/obj/item/reagent_containers/vessel/beaker/large,/obj/item/storage/box/handcuffs,/obj/item/storage/belt/abductor,/turf/simulated/floor/misc/abductor,/area/polarplanet/street)
"N" = (/obj/structure/table/abductor,/obj/item/cautery/alien,/obj/item/paper/guides/antag/abductor,/turf/simulated/floor/misc/abductor,/area/polarplanet/street)
"P" = (/turf/unsimulated/wall/abductor{icon_state = "alien6"},/area/polarplanet/street)
"Q" = (/obj/structure/table/abductor,/obj/item/hemostat/alien,/obj/item/FixOVein/alien,/obj/structure/snow,/turf/simulated/floor/misc/abductor,/area/polarplanet/street)
"S" = (/turf/unsimulated/wall/abductor{icon_state = "alien15"},/area/polarplanet/street)
"T" = (/turf/unsimulated/wall/abductor{icon_state = "alien19"},/area/polarplanet/street)
"U" = (/turf/unsimulated/wall/abductor{icon_state = "alien12"},/area/polarplanet/street)
"V" = (/obj/structure/snow,/turf/simulated/floor/misc/abductor,/area/polarplanet/street)
"X" = (/turf/unsimulated/wall/abductor{icon_state = "alien7"},/area/polarplanet/street)
"Y" = (/turf/unsimulated/wall/abductor{icon_state = "alien14"},/area/polarplanet/street)
"Z" = (/turf/unsimulated/wall/abductor{icon_state = "alien10"},/area/polarplanet/street)

(1,1,1) = {"
BBBBBBBBBBBBBBBBaaaaBBBBBBBBBBBBBBBBBBBBBBBBBBBBBB
BBBBBBBBBBBBBBBBaaaaBBBBBBBBBBBBBBBBBBBBBBBBBBBBBB
BBBBBBBBBBBBBBBBaaaaBBBBBBBBBBBBBBBBBBBBBBBBBBBBBB
BBBBBBBBBBBBBBBaIaaaaBBBBBBBBBBBBBBBBBBBBBBBBBBBBB
BBBBBBBBBBBBBBBaIaaIaBBBBBBBBBBBBaaaaaBBBBBBBBBBBB
BBBBBBBBBBBBBBBaIaaIaaBBBBBaaaaBBaaaaaaBBBBBBBBBBB
BBBBBBBBBBBBBBBIbaaIIIaBBBBaaaaaaIIIIIaaaaaaaBBBBB
BBBBBBBBBBBBBBaIIaaaaaaaaBBaaaaaaaaaaaaaaaaaaBBBBB
BBBBBBBBBBBBBBabbaaaaaaaaaaaaaaaaaaaaaaaaaaaaBBBBB
BBBBBBBBBBBBaaaIbaIIIIIIIaaIIIIaaaaaaaaaaaaaaBBBBB
BBBBBBBBBBBBaaaaIaIIaaaaaaaaaaaaaaaaaaaaaaaaaBBBBB
BBBBBBBBBBaIbaaaIaIIaaaaaaaaaIIIIaaaaaaaaaaaaBBBBB
BBBBBBBBBaIbbaaIbaIIaaaaaaaaaIIIIaaaaaaaaaaaIaaBBB
BBBBBBBBBaaaaaaaIaIIaaaaaaaaaIIIIaaaaaaaaaaaIaaBBB
BBBBBBBBBaaaaaaaIaIIaaaaaaaaabbbbIIIIIIIIIIIIaaBBB
BBBBBBBBBaaaaaaaIaIIaaaaaaaaabbbbIIIIIIIbbttbIaaBB
BBBBBBBBBaaaaaaaIaIIIaaaaaaaabbbbbbbbbbIbbttbIaaaB
BBBBBBBBBaaaaaaaIaIIIIaIaaaaaIIaIIIIIIIaIIbbIIaIaa
BBBBBBBBBaaaaaaaIaIIIIaIaaaaaIIaIIIIIIIaIIbbIIaIaa
BBBBBBBBBaaaaaaaIaIIIIIIaaaaaIIaIIIIIIIaIIbbIIaIaa
BBBBBBaIIbIIIIIIbIbbIIIIaaaaaIIaIIIIIIIaIIbbIIaIaa
BBBBBBaIIbIIIIIIbIIIaaaIaaaaaIaaIIIIIIIaIIbbIIaIaa
BBBBBBaIbtbbbIIIbIIIaaaaofeaaIaaIIIIIIIIIIbbaaaIaa
BBBBBBaIbtbbbIIIbIIIaEadVyqTaIaaIIIIIIIIIIttIIIbaa
BBBBBBaIbbIIIaaaaaaaaYVmLVMSaIaaIIIIIIIIIIttIIIbaa
BBBBBBBaIIIIIaaaaaaaaUQVvDpGaIaaaaaaaaaaaabtbbbbaa
BBBBBBBaIIIIIaaaaaaIaZNwAjnCaIaaaaaaaIIaaabtbbbbaa
BBBBBBBIbbIIIaaaaaabaPXDuDJgaIaaaaaaaIIaaabtbbbbIa
BBBBBBabIIaaaaaaaaaIaahxizFaaIaaaaaaaIIaaaIIaaaIIa
BBBBBBabIbIIaaaaaaaIaaaaaaaaaIIIIIIIIbbIIaIIaaaIIa
BBBBaaItIbIIaaaaaaaIaaaaaaaaaaaaaaaaaIIIIaIbIIaaaB
BBBBaaabIbIIaaaaaaaIaaaaaaaaaaaaaaaaaIIIIaIbIIaaaB
BBBBaaItbbIIaaaaaaaIaaaaaaaaaaaaaaaaaaaaaaIIaaaaaB
BBBBaaIbIIIIaaaaaaaIaaaaaaaaaaaaaaaaaaaaaaIIaaaaaB
BBBBaaIbIIIIaaaaaaIbIIIIIIIIaaaaaaaaaaaaaaIIaaaaaB
BBBBBBaIIaaaaaaaaaIbIIIIIIIIaaaaaaaaaaaaaaaaBBBBBB
BBBBBBaIIaaaaaaaaaIbIIIIIIIIaaaaaaaaaaaaaaaaBBBBBB
BBBBBBaIIaaaaaaaaaIbIIIIIIbbIIIIbbbbIIIaaaaaBBBBBB
BBBBBBBaaaaaaaaaaaIIaaaaaaIIaaaaIIIbIIaIaBBBBBBBBB
BBBBBBBaaaaaaaaaaaIIaaaaaaIbIaaaIIIbIIaIaBBBBBBBBB
BBBBBBBaaaaaaaaaaaIIaaaaaaaIaBBaaaaIaaaaBBBBBBBBBB
BBBBBBBaaaaaaaaaaaIIaaaaaaaIaBBBaaaIaaaBBBBBBBBBBB
BBBBBBaIbIIaaaaaaIbbIIaaaaaaBBBBaaaIaaaBBBBBBBBBBB
BBBBBBaIbIIaaaaaaIbbIbIIIaaaBBBBBBaaaaBBBBBBBBBBBB
BBBBBBaaIaIaaBBBBaaaaIaaaaaBBBBBBBBaaaBBBBBBBBBBBB
BBBBBBaaIaIaaBBBBaaaaIaaaaBBBBBBBBBBBBBBBBBBBBBBBB
BBBBBBBBaaIaaBBBBBBBBaaaaaBBBBBBBBBBBBBBBBBBBBBBBB
BBBBBBBBBBaaaBBBBBBBBaaaaBBBBBBBBBBBBBBBBBBBBBBBBB
BBBBBBBBBBBBBBBBBBBBBBBBBBBBBBBBBBBBBBBBBBBBBBBBBB
BBBBBBBBBBBBBBBBBBBBBBBBBBBBBBBBBBBBBBBBBBBBBBBBBB
"}
