"a" = (/turf/unsimulated/floor/frozenground,/area/polarplanet/street)
"d" = (/obj/structure/flora/tree/pine,/obj/structure/snow,/turf/unsimulated/floor/frozenground,/area/polarplanet/street)
"e" = (/mob/living/simple_animal/hostile/retaliate/beast/diyaab,/obj/structure/snow,/turf/unsimulated/floor/frozenground,/area/polarplanet/street)
"f" = (/obj/structure/flora/tree/pine,/obj/structure/flora/grass/green,/obj/structure/flora/grass/green,/turf/unsimulated/floor/frozenground,/area/polarplanet/street)
"g" = (/obj/structure/flora/tree/pine,/obj/structure/flora/grass/brown,/turf/unsimulated/floor/frozenground,/area/polarplanet/street)
"h" = (/obj/structure/flora/grass/brown,/obj/structure/flora/grass/brown,/obj/structure/flora/grass/green,/turf/unsimulated/floor/frozenground,/area/polarplanet/street)
"j" = (/obj/structure/flora/grass/brown,/obj/structure/flora/grass/green,/obj/structure/flora/grass/green,/turf/unsimulated/floor/frozenground,/area/polarplanet/street)
"k" = (/obj/structure/flora/grass/green,/turf/unsimulated/floor/frozenground,/area/polarplanet/street)
"l" = (/obj/structure/flora/tree/pine,/obj/structure/flora/grass/brown,/obj/structure/snow,/turf/unsimulated/floor/frozenground,/area/polarplanet/street)
"n" = (/obj/structure/flora/grass/brown,/obj/structure/flora/grass/green,/obj/structure/snow,/turf/unsimulated/floor/frozenground,/area/polarplanet/street)
"o" = (/obj/structure/flora/tree/pine,/turf/unsimulated/floor/frozenground,/area/polarplanet/street)
"p" = (/obj/structure/flora/tree/pine,/obj/structure/flora/grass/green,/obj/structure/flora/grass/green,/obj/structure/snow,/turf/unsimulated/floor/frozenground,/area/polarplanet/street)
"r" = (/obj/structure/snow,/obj/structure/flora/grass/green,/turf/unsimulated/floor/frozenground,/area/polarplanet/street)
"s" = (/obj/structure/flora/grass/brown,/turf/unsimulated/floor/frozenground,/area/polarplanet/street)
"v" = (/obj/structure/flora/tree/pine,/obj/structure/flora/grass/green,/turf/unsimulated/floor/frozenground,/area/polarplanet/street)
"w" = (/obj/structure/snow,/obj/structure/snow,/turf/unsimulated/floor/frozenground,/area/polarplanet/street)
"x" = (/obj/structure/flora/grass/green,/obj/structure/flora/grass/green,/obj/structure/flora/grass/green,/turf/unsimulated/floor/frozenground,/area/polarplanet/street)
"y" = (/obj/structure/flora/tree/pine,/obj/structure/snow,/obj/structure/snow,/turf/unsimulated/floor/frozenground,/area/polarplanet/street)
"A" = (/mob/living/simple_animal/hostile/tree,/obj/structure/snow,/turf/unsimulated/floor/frozenground,/area/polarplanet/street)
"B" = (/turf/unsimulated/floor/frozenground,/turf/unsimulated/floor/frozenground,/area/polarplanet/street)
"D" = (/obj/structure/flora/tree/pine,/obj/structure/flora/grass/brown,/obj/structure/flora/grass/green,/obj/structure/snow,/turf/unsimulated/floor/frozenground,/area/polarplanet/street)
"E" = (/obj/structure/flora/grass/brown,/obj/structure/flora/grass/brown,/obj/structure/flora/grass/green,/obj/structure/snow,/turf/unsimulated/floor/frozenground,/area/polarplanet/street)
"F" = (/obj/structure/snow,/turf/unsimulated/floor/frozenground,/area/polarplanet/street)
"G" = (/obj/structure/gravemarker/cross,/turf/unsimulated/floor/frozenground,/area/polarplanet/street)
"I" = (/obj/structure/flora/grass/green,/obj/structure/flora/grass/green,/turf/unsimulated/floor/frozenground,/area/polarplanet/street)
"K" = (/obj/structure/flora/tree/pine,/obj/structure/flora/grass/green,/obj/structure/snow,/turf/unsimulated/floor/frozenground,/area/polarplanet/street)
"L" = (/obj/structure/gravemarker/cross,/obj/structure/snow,/turf/unsimulated/floor/frozenground,/area/polarplanet/street)
"N" = (/obj/structure/flora/grass/green,/obj/structure/flora/grass/green,/obj/structure/snow,/turf/unsimulated/floor/frozenground,/area/polarplanet/street)
"P" = (/obj/structure/flora/grass/green,/obj/structure/snow,/turf/unsimulated/floor/frozenground,/area/polarplanet/street)
"Q" = (/obj/structure/snow,/obj/structure/flora/grass/brown,/turf/unsimulated/floor/frozenground,/area/polarplanet/street)
"R" = (/obj/structure/snow,/obj/structure/flora/grass/green,/obj/structure/flora/grass/brown,/turf/unsimulated/floor/frozenground,/area/polarplanet/street)
"S" = (/obj/structure/flora/grass/brown,/obj/structure/flora/grass/brown,/turf/unsimulated/floor/frozenground,/area/polarplanet/street)
"T" = (/obj/structure/flora/grass/brown,/obj/structure/flora/grass/brown,/obj/structure/snow,/turf/unsimulated/floor/frozenground,/area/polarplanet/street)
"U" = (/obj/structure/flora/grass/brown,/obj/structure/flora/grass/green,/turf/unsimulated/floor/frozenground,/area/polarplanet/street)
"X" = (/obj/structure/flora/grass/brown,/obj/structure/snow,/turf/unsimulated/floor/frozenground,/area/polarplanet/street)
"Y" = (/obj/structure/flora/grass/green,/obj/structure/snow,/obj/structure/snow,/turf/unsimulated/floor/frozenground,/area/polarplanet/street)
"Z" = (/obj/structure/flora/tree/pine,/obj/structure/flora/grass/brown,/obj/structure/flora/grass/green,/turf/unsimulated/floor/frozenground,/area/polarplanet/street)

(1,1,1) = {"
aaaaaaaaaaaaaaaaaaaaaaaaaaaaaaaaaaaaaaaaaaaaaaaaaaaaaaaaaaaaaaaaaaaaaaaaaaaaaaaaaaaoasaaaaaaaFFFFaaaaoaaaaakXXFnFFaaaaaaaaaaaFaaaaaaaaaakaagaaaFFaaaaa
aaaaaaaaaaaaaaaaaaaaaaaaaaaaaaaaaaaaaaaaaaaaaaaaaaaaaaaaaaaaaaaaaaaaaaaaaaaaaaaaaaaaaasaaFdFFFFFFaaaaaaPFosFFFaFXFaaaaaoasaFaoFFFFFFFFdFFdFFXFFFPaaaaa
aaaaaaaaaaaaaaaaaaaaaaaaaaaaaaaaaaaaaaaaaaaaaaaaaaaaaaaaaaaaaaaaaaaaaaaaaaaaaaFFFFaaaagkFFFFFFPFFaaaaaaFaaadPFaFXaaoaasaaaaaaFFFPFFFlFFFFPFFXFFFaaaaaa
aaaaaaaaaaaaaaaaaaaaaaaaaaaaaaaaaaaaaaaaaaaaaaaaFaaaFFFaaaaaaaaaaaaaaaaaaaaaaaFFFFaaaaaFFFFFFFFFPaaaaaaFkaaFFXaaaUaaksafaaoaaaFXFFFFFFXFFFFdFXFaaaaaaa
aaaaaaaaaaaaaaaaaaaaaaaaaaaaaaaaaaaaaaaaaaaaaaaFFFFFdFFFFFFaaaaaaaaaaaaaaaaaaanFPkaaaaFXPXFXdXFXXaaaaaaFaaaaaFnFadFFFFFFeFeFFFFFFFFFFFFFFFFFaFaaaaaaaa
aaaaaaaaaaaaaaaaaaaaaaaaaaaaaaaaaaaaaaaaaaaaaaFFFFXFFFFFFFFFaaaaaaaaaaaaaaaaaasFFFaaaaFFFPFFFPFFdaaaaaaavFFsaaasFaXkoFdFFFFFFFFFFFFFFFFFFFFaaaaaaaaaaa
aaaaaaaaaaaaaaaaaaaaaaaaaaaaaaaaaaaaaaaaaaaaaaaFFFFaFFaFFFFFFFaaaaaaaaaaaaaaaaaaFFaaaaFFFXPFFFFFFaaaaaaaaPPaaaaagaFFnFFeFFFeFFFFFFdFFFFFFFFaaaaaaaaaaa
aaaaaaaaaaaaaaaaaaaaaaaaaaaaaaaaaaaaaaaaaaaaaFFFFgaaFnadFFFPdFaFaaaaaaaaaaaaaaosFFaaadFFFFFPXsFnFaaaaaaoaaakFdFFPXFXahFFFeFFFFFFFFFFFFFFFFFaaaaaaaaaaa
aaaaaaaaaaaaaaaaaaaaaaaaaaaaaaaFaaaaaaaaaaaaaFFFFFFsaaaFFPFFFFFaaaFaaaaFFaaaaaFTXaaaaFFPFdXFFFFFsaaaaaaaaaaaUFFFFFFnsoFFFFFFFFFFFFFFFFFFFFFFaaaaaaaaaa
aaaaaaaaaaaaaaaaaaaaaaaaaaaaaaasaaaaaaaaaaaaaFFFFPFasaaasaaFFFFaaaaFaFaoaaaaaFFPFaaaFFFFFFFdPFFasaaaaaaaaaaaFdFFFFFFaasaFPFnaFFPFFFdFFFFFFFFaaaaaaaaaa
aaaaaaaaaaaaaaaaaaaaaaaaaaaaaoasFFaaFFaaaaaaaaFFFPIakIasaaaFFFFFFaaaaaFaaaaaaFFFXlaaFFFFPFFFFXFFaaaaaaaaaaaFFFaaPaUaaFaaFXFPsdFFFFFFFFFFFFFFFaaaaaaaaa
aaaaaaaaaaaaaaaaaaaaaaaaaaaaaaFaXFFadFFFaaaaaaFdFaXsaavakFPPPFPFFFFFFaaaFaaaaaXFFFaFFFFFFFFFFFUaaaaaaaaaaaaFFFaaaaaaFaFsaaaskXFFFFFdFFFFFFFFFaaaaaaaaa
aaaaaaaaaaaaaaaaaaaaaaaaaaaaaaFagPFFFFFFkaaaaaFFFFadLXFFPsaoaaFFFFFFFFFFFFaaaaFFFFaFFFFFKFFXFaasaaaaaaaaaaFFFdasaFaoaFaZaasavFFFFPFFFFFFFFFFaaaaaaaaaa
aaaaaaaaaaaaaaaaaaaaaaaaaaaaaaaaaaaaaaFFFFkaasaXFaFaFFFFFFFaaZFFXFKFFFFPFFaaaaFXFFaFFFFFFPPFFaaagaaaaaaaaaFFXFaaaaaFFFPasaakFFFFFFFFFFFFFFFFaaaaaaaaaa
aaaaaaaaaaaaaaaaaaaaaaaaaaaaaaaaFskXasosassaaPaFFaaaaFFFFFFakasaFPFFFFFakFaaaaFFFFaaFFFdFFFkaoaakaaaaaaaaaFFFpaaoaaFFXFaaoaFPFaFdFFFFFFFFFFaaaaaaaaaaa
aaaaaaaaaaaaaaaaaaaaaaaaaaaaaaaaaaakaaaPaFoaaFFFFoaFaFFFFaXaaaaoaakaaaoaaFFaaaaaFFaaaFFFFFFaUaaaFaaaaaaaaaFFFFsaaaFFFFaaaFaFFFsFFFFFFFFFFFFaaaaaaaaaaa
aaaaaaaaaaaaaaaaaasaaaaaaaaaaaaFaaasPaFFFFFFsFFFFaaakaUaFaaavaaaaaaasaaaoFFFaFsaFFaaaaFFFFFaFkaaaaaaXFaaaaFFFFFoaaFFFaaFFaaakXaFFdFFFFFFFFFaaaaaaaaaaa
aaaaaaaaaaaaaaaaoasaaaaaaaFaaaaoaaaaakXXFnFFaaaaaaaaaaaFaaaaaaaaaakaagaaaFFaaFFasFaaaaaFFFdFFsgakaoFXFFaaaaFFFFaaaaaaaFaaadFFaaXFFFFFFFFFaFFaaaaaaaaaa
aaaaaaaaaaaaaaaaaaasaaFdFFFaaaaaaPFosFFFaFXFaaaaaoasaFaoFFFFFFFFdFFdFFXFFFPaaFFaaFaaaaaFFFFFFaasoaaFFXFaaoaFFFFaaaaaoaaagaFFFaaFFFFFFFFFaaaFaaaaaaaaaa
aaaaaaaaaaaaaaaaaaagkFFFFFFaaaaaaFaaadPFaFXaaoaasaaaaaaFFFPFFFlFFFFPFFXFFFaaoFagaFaaaaaaFFFaaagaFaaaFlPaaaaaaFFaoaaFasssaasFFagFFFnFdFFakoFFaaaaaaaaaa
aaaaaaaaaaaaaaaaaaaaFFFFFFFaaaaaaFkaaFFXaaaUaaksafaaoaaaFXFFFFFFXFFFFdFXFaaaaakaaXaaaaaaFFFaaasaFaaaFFaFFaaaaaFkaasFXFaaaaaasPFFXFaaaFPaaaFFaaaaaaaaaa
aaaaaaaaaaaaaaaaaaaFXPXFXdXaaaaaaFaaaaaFnFadFFFFFFeFeFFFFFFFFFFFFFFFFFaFaaaaaakkaaaaaaaaaFFoaaaoaaaaFaXPXasosassaakaFFoaaaaaakkFFXaaaXFaaFFFFaaaaaaaaa
aaaaaaaaaaaaaaaaaaaFFFPFFFPaaaaaaavFFsaaasFaXkoFdFFFFFFFFFFFFFFFFFFFFaaaaaaaaaaPIFaaaaaaaFFFFFFXFaaaaaFFPFaaPFaoaaaaakaaoaaaaaPNFkIasFFaaFFFFoaaaaaaaa
aaaaaaaaaaaaaaaaaaaFFFXPFFFaaaaaaaaPPaaaaagaFFnFFeFFFeFFFFFFdFFFFFFFFaaaaoaaaaaFssaaaaaaaaFFFFFXFaaaaaaasPaaFFFFFXFaaasaaasoaaassaavakFkkPFPPFaaaaaaaa
aaaaaaaaaaaaaaaaaadFFFFFPXsaaaaaaoaaakFdFFPXFXahFFFeFFFFFFFFFFFFFFFFFaaaaaaaaFaaPaaaaaaaaFFFFFFFXaaaoaFaaakssanFFaaaaaakaIaosaaaoasaaksaoaaaFFFaaaaaaa
aaaaaaaaaaaaaaaaaaaaaaaaaaaaaaaaaaaaaaUFFFFFFnsoFFFFFFFFFFFFFFFFFFFFFFaaasaaaaFTssaaaaaaaFFFFFFFdaaaaaPaosaaFFFXFaaaaoaSoaaaaasaaskaaaFFFFaaFFaaaaaaaa
aaaaaaaaaaaaasaaaaaaaaaaaaFaaaaaaaaaaaFdFFFFFFaasaFPFnaFFPFFFdFFFFFFFFaaasaaaaFYaaaaaaaaFFFFFFFFFaaaaaaaFaokFFFXFaoaaskaIaosFFFoaFaaoFFFFXFFaaaaaaaaaa
aaaaaaaaaaaoasaaaaaaaFFFFFFaaaaaaaaaaFFFaaPaUaaFaaFXFPsdFFFFFFFFFFFFFFFaaaaaaFaaoaaaaaaFFFFFFFFFFaaaaaakaaaaFXaaUaakXFToaaaaFXFaaFFFFFdFFFXFaoaaaaaaaa
aaaaaaaaaaaaaasaaFdFFFFFFFFaaaaaaaaaaFFFaaaaaaFaFsaaaskXFFFFFdFFFFFFFFFaaaasaaFaaaaaaaaFFFFFFFFFFaaaaaFFFFFasaUaoaaaFFPsUnFFFPXFaFFFFFFFFaaaaaaaaaaaaa
aaaaaaaaaaaaaagkFFFFFFPFFFFaaaaaaaaaFFFdasaFaoaFaZaasavFFFFPFFFFFFFFFFaoaaaaaFFaaaaaaaaaFFFFFFFFFaaaaaFKFFFaaUoaFXPdFFPFFdXFFFFFaaFFFaaaaaaaaaaaaaaaaa
aaaaaaaaaaaaaaaFFFFFFFFFPFFaaaaaaaaaFFXFaaaaaFFFPasaakFFFFFFFFFFFFFFFFaaaaaaaFFaaoaaaaaaaFFFFdFFFaaaaaaaPPnFFdagFFFnFFFFFkFXPdFFoaFFFaaaaaaaaaaaaaaaaa
aaaaaaaaaaaaaaFXPXFXdXFXXFFaaaaaaaaaFFFpaaoaaFFXFaaoaFPFaFdFFFFFFFFFFaaaaaaaaaFaFaaaaaaaaaFFFFFFYaaaaaoaFFFXFFFPXFXFEnFakaaFFnFFaaaaaaaaaaaaaaaaaaaaaa
aaaaaaaaaaaaaaFFFPFFFPFFdFFaaaaaaaaaFFFFsaaaFFFFaaaFaFFFsFFFFFFFFFFFFaaaaaoaaadaaaaaaaaaaaaaFFFFFaaaaaaaaFFagaXFFFFFFFFaaaaaXFEnFaaaaaaaaaaaaaaaaaaBBB
aaaaaaaaaaaaaaFFFXPFFFFFFFsaaaXFaaaaFFFFFoaaFFFaaFFaaakXaFFdFFFFFFFFFaaaaaaaaaaFaaaaaaaaaaaaFdFsaaaaaaaaaaaaksFFFFaaFFaaaaaaaaaaaaaaaaaaaaaaaaaaaaaaaa
aaaaaaaaaaaaadFFFFFPXsFnFFaaoFXFFaaaaFFFFaaaaaaaFaaadFFaaXFFFFFFFFFaFFaaaaaaaaaFFaaaaaaaaaaFXaaaaaaaaaaaaaaaaaaFFaaaaaaaaaaaaaaaaaaaaaaaaaaaaaaaaaaFFF
aaaaaaaaaaaaaFFPFdXFFFFFsaaaaFFXFaaoaFFFFaaaaaoaaagaFFFaaFFFFFFFFFaaaFaaaaasaaFFFFaaaaaFFXaFFfFaoaaaaaaaaaaaaaaaaaaaaaaaaaaaaaaaaaaaaaaaaaaaaaaaaaaFFF
aaaaaaaaaaaaFFFFFFFdPFFasaaaaaFlPaaaaaaFFaoaaFasssaasFFagFFFnFdFFakoFFaaaaaaaFFPFFaassFFFaoakssaFsaasavaaaaaaasaaaoFFFFFFFFFFaaaaaaaFoaaaaFFFaFXFXDnFP
aaaaaaaaaaaaFFFFPFFFFXFFaUaaaaFFaFFaaaaaFkaasFXFaaaaaasPFFXFaaaFPaaaFFaaaaaaaaaakFaFFFssaaaaassaaaagskaaaaaakaagFFFFFFFFFFFFFaaaaaaaFFaaaFFFFaFFPPasFF
aaaaaaaaaaaFFFFFFFFFFFUaaoaaaaFaXPXasosassaakaFFoaaaaaakkFFXaaaXFaaFFFFaaaaaaaoaaaaFFFaaaakaaaFassaakFFaaaoaaoaaXFFFPFFFFFFFaaaaaaaaFFaaaFFFFaFPFFaaaF
aaaaaaaaaaaFFFFFKFFXFaasaasaaaaaFFPFaaPFaoaaaaakaaoaaaaaPNFkIasFFaaFFFFoaaaaaaaaoFFFFFaaoaksdsasossvFaaagaFFFkaasaaFFFFFFFFaaaaaaaaaFFaaaFFFaaPFFFaosF
aaaaaaaaaaaFFFFFFPPFFaaagaaaaaaaaasPaaFFFFFXFaaasaaasoaaassaavakFkkPFPPFaaaaaaFFFFFFFFoaaaaaaaFasakaaFFaaaXFFaaoasaFFFFFFFaaaaaaaaaaFFaaaaFFaaaaaaXFTX
aaaaaaaaaaaaFFFdFFFkaoaakXFaaaoaFaaakssanFFaaaaaakaIaosaaaoasaaksaoaaaFFFaasaaXFFFFFFFwPFFFoaaaSaaaaaaaaaFFFXaaaasoFFFPFFaaaaaaaaaaaFFaaaaFFaasaaFFFPF
aaaaaaaaaaaaaFFFFFFaUaaaFFFaaaaaPaosaaFFFXFaaaaoaSoaaaaasaaskaaaFFFFaaFFaaosaasaaFFFFFPFFFFFXFXXFXFXFFdaaFFaaFXFlFFFFFPPFaaaaaaaaaaaFFFaaaFFFaaFoFFFFX
aaaaaaaaaaaaaaFFFFFaFkaaaaaaaaaaaaFaokFFFXFaoaaskaIaosFFFoaFaaoFFFFXFFaaaaaaaaasaFaFFFFFFFFlFFFFFFdFFdXaoaaFaFFFFFFFFdFFFaaaaaaaaaaaFFFaaaFFFaaakXFXFF
aaaaaaaaaaaaaaaFFFdFFsgakaaaaaaaakaaaaFXaaUaakXFToaaaaFXFaaFFFFFdFFFXFaoaaaaaaasoFaaFdFFFFFFFFFFFFFFFFFFFFsoaXFFXFFFFFFFaaaaaaaaaaaaFFFFaaaFFaaUaFPFFF
aaaaaaaaaaaaaaaFFFFFFaasokoaaaaaFFFFFasaUaoaaaFFPsUnFFFPXFaFFFFFFFFaaaaaaaasaalFFaaaFFFFFFFFFFFdFFFFFFFFFFaaaaaaFFXFXaaaaaaaaaaaaaaaFFFFaaaFFagkaPFFXF
aaaaaaaaaaaaaaaaFFFaaagaFskaaaaaFKFFFaaUoaFXPdFFPFFdXFFFFFaaFFFaaaaaaaaaaaaaaaFFFFaaaaFFFdFFFFFFFFFFFFaaaaaaaaaoFFFFFaoaaaaaaaaaaaaaFFFFFaaaFFasskaFFF
aaaaaaaaaaaaaaaaFFFaaasaFaaaaaaaaaPPnFFdagFFFnFFFFFkFXPdFFoaFFFaaaaaaaaaaaaaaaXFFFaaaaaaaFFFFFFFFFaaoaaaaaaaaaaaaaaaaaaaaaaaaaaaaaaaFPdFFaaaaFakassaaF
aaaaaaaaaaaaaaaaaFFoaaaoaaoaaaaaoaFFFXFFFPXFXFEnFakaaFFnFFaaaaaaaaaaaaaaaaaaaaFaXFXaaaaaaaaaaaaaaFFFdFFsgakaakPXaaaakaFakakaaXFFFaaPFFFFFFaaaFkaIaosaF
aaaaaaaaaaaaaaaaaFFFFFFXFFFaaaaaaaaFFagaXFFFFFFFFaaaaaXFEnFaaaaaaaaaaaaaaaaaaaFFFFFaoaaaaaaaaaaaaFFFFFFaasokoaPFsvkokaFPaakkaasaaasFFFFFFFaaaFSoaaaaas
aaaaaaaaaaaaaaaaaaFFFFFXFFFaaaaaaaaaaaksFFFFaaFFaaaaaaaaaaaaaaaaaaaaaaaaaaaaaaaaaaaaaaaaaaaaaaaaaaFFFaaagaFskaIFaasaaaaFaaaPIFkIasFFFFFFFFdaFFksUUaaaa
aaaaaaaaaaaaaaaaaFFFFFFFXXFaaaaaaaaaaaaaaFFaaaaaaaaaaaaaaaaaaaaaaaaaaaaaaaaaaaaaoaaaaaFFaaasaaaaaaFFFaaasaFaaasxPPaaosasndFFssaavFPFPPPFPPaaFakaaosaga
aaaaaaaaaaaaaaaaaFFFFFFFdFXaaaaaaaaaaaaaaaaaaaaaaaaaaaaaaaaaaaaaaaaaaaaaaaaaaasaaskoaFFaaaakaaaaaaaFFoaaaoaaoasaPFskakaFXFFFPaGsaFPXFdFFFFaaFaaFakakaa
aaaaaaaaaaaaaaaaFFFFFFFFFFXXFFFkkkPaoassaaaaaaFFaaaaaFFaaaaaFFFaaaFaFFFFPPFFaaagaaaUaFFkoakaaaaaaaaFFFFFFXFFFFgIFFFaaagaPnFTssskaFFFFFFFFFFFFFaFPaakka
aaaaaaaaaaaaaaaFFFFFFFFFFFFnFFUkasUaasskaaaoaFFAaaaFFFFFaaaFaaFaaaaFFFdFFFkaoaakXFsahUssaUSoaaaaaaaaFFFFFXFFFFskjaakdkaPFPFPaaFaaoFFFFXFFFFaaFaaFaaaPI
aaaaaaaaaaaaaaaFFFFFFFFFFFFFoaaasaaoaasaaaFaaFFFFaaFFFFFFaaaFFFFaaaaFFFFFFaUaaaFFFUsoskUsaksaaaaaaaFFFFFFFXXFFdnFkaNFFakaaaaoaaaaaadFFFXFFdaaFsasndFFs
aaaaaaaaaaaaaaaaFFFFFFFFFFdFkssFvaaUasaaoaaaaFFFFrrFFFFFdaaaFFRFFaaaaFFFFFaFkaaaaaaUoaoakakaaaaaaaaFFFFFFFdFXFFFFZaFFFssoFaaFaaaFaaFFFFFaaaaFFkaFXFFFP
aaaaaaaaaaaaaaaaaFFFFdFFFFFFaasaakaUaaaPFFFFdFFFrrFFFFFFFaaaFrrFFFaaaaFFFdFFsgakaakPXaaaakaFaaaaaaFFFFFFFFFFXXFFFkkkPaoassaaaaaFFFFFFFFFFaaFFaagaPnFTs
aaaaaaaaaaaaaaaaaaFFFFFFYFnaFaaaasFksoFFFFFFFFFFrFFFFFFFaaaFFrFFFFaaaaFFFFFFaasokoaPFsvkokaFaaaaaaaaaaaaaaaaaaaaaaaaaaaaaaaaaaaaaaaaaFFFFaaFFaaaPFPFPa
aaaaaaaaaaaaaaaaaaaaFFFFFFFaaaFsaaasksaFFaaaaFFFFFFFaaaaaaaaaaFaaaFFFaaaaaaaaaaaaaaaaaaaaaaaaaaaasaaaaaaaaaaaaFFFFFFFFFaaFFFFFFFFFaaaaFFFFFFFaaakaaaao
aaaaaaaaaaaaaaaaaaaaFdFsaaFoFaaZaasavaFFFaaoaaaaFaPFaoaaasaaaFFFFFdFFFFFFaaaaaaaaaaaaaaaaaaaaaaoasaaaaaaaFFFFFFFFFFFFFFFFFFFFFFFFFFFaaaFFFaFFaaasoFaaF
aaaaaaaaaaaaaaaaaaaFXaaaaaFaaFkasaakaaaaaaaaaaaaaaakFFkassaaFFFFXFFFFFFFFFaaaaaaaaaaaaaaaaaaaaaaaasaaFdFFFFFFFFFFdFFFdXFXFXDnFPkdFFFFaaFFFFFFaaaassaaa
aaaaaaaaaaaaaaaFFXaFFfFaoaFaasaaadaakaaaoaaaaaaaaaaakPFasaaaaFFFFaFFaFFFFFFFaaaaaaaaaaaaaaagaaaaaagkFFFFFFPFFFFFFFXXXFFFFPPasFFFFFFywaaFaFFFFaaasskaaa
aaaaaaaaaaaassFFFaoakssaFsaasavaaaaaaasaaaaaaaaakaaoakksaaaFFFFgaaFnadFFFPdFaFaaaaaaaaaaaaaaaaaaaaaFFFFFFFFFPFFXFXFFFFFFPFFaaaFFFaaFFaaaaFFFaaaaasaaaF
aaaaaaaaaaaFFFssaaaaassaaaagskaaaaaakaagFaaaaFaaaaaaaassaaaFFFFFFsaaaFFPFFFFFaaaFaaaaFFaaaaaaaaaaaFXPXFXdXFXXFFPFFFdFFaPFFFaosFFFsaXFFFaaaaaaaaasaaoaa
aaaaaaaaaaaFFFaaaakaaaFassaakFFaaaoaaoaaXaaaasaaaaaaaaaaaaaFFFFPFasaaasaaFFFFaaaaFaFaaaaaaasaaaaaaFFFPFFFPFFdFFFFFPFFFaaaaaXFTXasasXFFFoaaaaaaaaaaPFFF
aaaaaaaaaaFFFFaaoaksdsasossvFaaagaFFFkaasaaoasFFaaFFaaaaaaaaFFFPIakIasaaaFFFFFFaaaaaFaaaaaaoaaaaaaFFFXPFFFFFFFsFFFasaIksaaFFFPFasaoaFFFFaaaaaaaaoFFFFF
aaaaaaaaaaFFFFoaaaaaaaFasakaaFFaaaXFFaaoaaaaFaXFFadFFFaaaaaaFdFaXsaavakFPPPFPFFFFFFaaaFaaaaaaaaaadFFFFFPXsFnFFaaFFaadFPaFoFFFFXlFFFFFFFFaaaaaaaasaFFFF
aaaaaaaaaaFFFFwPFFFoaaaSaaaaaaaaaFFFXaaaaaaaFagPFFFFFFkaaaaaFFFFadLXFFPsaoaaFFFFFFFFFFFFaaaaaFaaaFFPFdXFFFFFsaaaFFoaFPFaakXFXFFFFFFFFFFFaaaaaaaaaFFFPF
aaaaaaaaaaFFFFPFFFFFXFXXFXFXFFdaaFFaaFXFlaaaaaaaaaaaFFFFkaasaXFaFaFFFFFFFaaZFFXFKFFFFPFFaaaaaFaaFFFFFFFdPFFasaaoaasaXsXaUaFPFFFFFFFFFFFFaaaaaaaaaaaaak
aaaaaaaaaaaFFFFFFFFlFFFFFFdFFdXaoaaFaFFFFaaaaaFskXasosassaaPaFFaaaaFFFFFFakasaFPFFFFFakFaaaaaaaaaaaaaaaaaaaaaaaaaaaaaaaaaaaaaXFFFFFFFdFFaaaaaaaaaaaoaa
aaaaaaaaaaaaFdFFFFFFFFFFFFFFFFFFFFsoaXFFXaaaaaaaakaaaPaFoaaFFFFoaFaFFFFaXaaaaoaakaaaoaaFFaaFFFFFFFFFaaFFFFFFFFFaaaaaaaaaaaaaaFFFFFFFFFFFFaaaaaaaasaaao
aaaaaaaaaaaaFFFFFFFFFFFdFFFFFFFFFFaaaaaaFaaaaFaaasPaFFFFFFsFFFFaaakaUaFaaavaaaaaaasaaaoFFFaFFFFFFFFFFFFFFFFFFFFFFaaaaaaaaaaaaaFFFFdFFFFFFaaaaaaaaagFFF
aaaaaaaaaaaaaaFFFdFFFFFFFFFFFFaaaaaaaaaoFaaaaoaaaaakXXFnFFaaaaaaaaaaaFaaaaaaaaaakaagaaaFFaaFFFdFFFdXFXFXDnFPkdFFFFaaaaaaaaaaaaFFdFFFFFFFFFaaaaaaoaaXFF
aaaaaaaaaaaaaaaaaFFFFFFFFFaaoaaaaaaaaaaaaaFaaaaPFosFFFaFXFaaaaaoasaFaoFFFFFFFFdFFdFFXFFFPaaFFFFXXXFFFFPPasFFFFFFywaaaaaaaaaaaasFFFFaFFFFFFaaaaaakaasaa
aaaaaaaaaaaaaaaaaaaaaaaaaaaaaaaaaaaaaaaFXaFFFaaFaaadPFaFXaaoaasaaaaaaFFFPFFFlFFFFPFFXFFFaaaFXFXFFFFFFPFFaaaFFFaaFFaaaaaaaaaaaaaFFFFaFFFFFFFaaaaaaaoasa
aaaaaaaaaaaaaaaaaaaaaaaaaaaaaaaaaaaFFXaFFaaaFFFFkaaFFXaaaUaaksafaaoaaaFXFFFFFFXFFFFdFXFaaaaFPFFFdFFaPFFFaosFFFsaXFFFaaaaaaaaagaFFnFoaaFPdFFaaaaaaaaaso
aaaaaaaaaaaaaaaaaaaaaaaaaaaaaaaassFFFaoakaaaaFFFaaaaaFnFadFFFFFFeFeFFFFFFFFFFFFFFFFFaFaaaaaFFFFPFFFaaaaaXFTXasasXFFFoaaaaaaaaaaXFFFaaPFFFFFFaaaaFXFlFF
aaaaaaaaaaaaaaaaaaaaaaaaaaaaaaaFFFssaaaaaaaaFFaavFFsaaasFaXkoFdFFFFFFFFFFFFFFFFFFFFaaaaaaaasFFFasaIksaaFFFPFasaoaFFFFaaaaaaaakaasaaasFFFFFFFaaaaFFFFFF
aaaaaaaaaaaaaaaaaaaaaaaaaaaaaaaFFFaaaakaaaaFFaaaaPPaaaaagaFFnFFeFFFeFFFFFFdFFFFFFFFaaaaaaaaaaFFaadFPaFoFFFFXlFFFFFFFFaaaaaaaaPIFkIasFFFFFFFFdaaaXFFXFF
aaaaaaaaaaaaaaaaaaaaaaaaaaaaaaFFFFaaoaksdaaFaaaoaaakFdFFPXFXahFFFeFFFFFFFFFFFFFFFFFaaoaaaoaaaFFoaFPFaakXFXFFFFFFFFFFFaaaaaaaaFssaavFPFPPPFPPaaaaaaaFFX
aaaaaaaaaaaaaaaaaaaaaaaaaaaaaaFFFFoaaaaaaaFaaaaaaaaaUFFFFFFnsoFFFFFFFFFFFFFFFFFFFFFFaaaaaaaaoaasaXsXaUaFPFFFFFFFFFFFFaaaaaaaaFPaGsaFPXFdFFFFaaaaaaoFFF
aaaaaaaaaaaaaaaaaaaaaaaaaaaaaaaaaaaaaaaaaaFFFaaaaoaaFdFFFFFFaasaFPFnaFFPFFFdFFFFFFFFaaaaaaaaaPsFFFasgkaPFFXFFFFFFFdFFaaaaaaaaTssskaFFFFFFFFFFaaaaaaaaa
aaaaaaaaaaaaaaaaaaaaasaaaaaaaaaaaaFFFFFFFFFFFaaaaaaFFFaaPaUaaFaaFXFPsdFFFFFFFFFFFFFFFaaaaaaaFaaaFFaaasskaFFFFFFFFFFFFFaaaaaaaPaaFaaoFFFFXFFFFaaaaaaaaa
aaaaaaaaaaaaaaaaaaaoasaaaaaaaFFFFFFFFFFFFFFFoaaFFaaFFFaaaaaaFaFsaaaskXFFFFFdFFFFFFFFFaaaaaFFFaaaaaaaaaaaaaaaaaaaaFFFFFaaaaaaaaoaaaaaadFFFXFFdaaaaaaaaa
aaaaaaaaaaaaaaaaaaaaaasaaFdFFFFFFFFFFdFFFFaaaaFFFFFFFdasaFaoaFaZaasavFFFFPFFFFFFFFFFaaaaaaFFFFFFFFFaaaaFFFFFaaaaaFFFFFFaaaaaaaFaaaFaaFFFFFaaaaaaaaaaaa
aaaaaaaaaaaaaaaaaaaaaagkFFFFFFPFFFFFFFXXXaaaaaFFFFFFXFaaaaaFFFPasaakFFFFFFFFFFFFFFFFaaaaoaFFFFFFFFFFaFFFFFFFaaaaaFFFFFFaaaaaaaaaaFFFFFFFFFFaaaaaaaaaaa
aaaaaaaaaaaaaaaaaaaaaaaaaaaaaaaaaaaaaaaaaaaaaaaaaaFFFpaaoaaFFXFaaoaFPFaFdFFFFFFFFFFaaaaaaaaFFFFFFFFFaFFFFFFFaaaaaFFFFFFFaaaaaaaoaFFAFFFFFFFFaaaaaaaaaa
aaaaaaaaaaaaaaaaasaaaaaaaaaaaaFFFFFFFFFaaaaaaaaaaaFFFFsaaaFFFFaaaFaFFFsFFFFFFFFFFFFaaaaaaaaaaFFFFFFFFFFFaFFaFaaaaaaFPdFFaaaaaaFaaFFFFFFFFFFFFaaaaaaaaa
aaaaaaaaaaaaaaaoasaaaaaaaFFFFFFFFFFFFFFFFaaaXFaaaaFFFFFoaaFFFaaFFaaakXaFFdFFFFFFFFFaaaaaaaaaaaFFFFFFFFFaaFFFFaaaaaPFFFFFFaaaaaaaaFFFFFFFFFFFdaaaaaaaaa
aaaaaaaaaaaaaaaaaasaaFdFFFFFFFFFFdFFFdXFXaoFXFFaaaaFFFFaaaaaaaFaaadFFaaXFFFFFFFFFaFFaoaaaaaaaaFFFFFFFFaFaaFFFaaaasFFFFFFFaaaaFFFdFFFFFFFFFFFFaaaaaaaaa
aaaaaaaaaaaaaaaaaagkFFFFFFPFFFFFFFXXXFFFFaaFFXFaaoaFFFFaaaaaoaaagaFFFaaFFFFFFFFFaaaFaaaaaaaaaaaFFFFaFFaFoaaFFFaaaFFFFFFFFdaaaFFFFFFFFFFFFFFFaaaaaaaaaa
aaaaaaaaaaaaaaaaaaaFFFFFFFFFPFFXFXFFFFFFPaaaFlPaaaaaaFFaoaaFasssaasFFagFFFnFdFFakoFFaaaaaaaaaaaFFFFaFaaFFaaFFFaaaPFPPPFPPaaaFFFFFFFFFFFFFFFaaaaaaaaaaa
aaaaaaaaaaaaaaaaaaFXPXFXdXFXXFFPFFFdFFaPFaaaFFaFFaaaaaFkaasFXFaaaaaasPFFXFaaaFPaaaFFaaaaaaFFFaaFFFFFFaaaFaaFFFFaaPXFdFFFFaaaFPFFFFFrrQFFFFaaaaaaaaaaaa
aaaaaaaaaaaaaaaaaaFFFPFFFPFFdFFFFFPFFFaaaaaaFaXPXasosassaakaFFoaaaaaakkFFXaaaXFaaFFFFaaaaaFFFoaFFFFFaaaaaaaFFFFaaFFFFFFFFFaFFakFFFFQQrFFFFaaaaaaaaaaaa
aaaaaaaaaaaaaaaaaaFFFXPFFFFFFFsFFFasaIksaaaaaaFFPFaaPFaoaaaaakaaoaaaaaPNFkIasFFaaFFFFoaaaaFFFFaaFFFFaaaaFaaaFFFaaFFFFXFFFFaFFaaFFFFFFFFFFFaaaaaaaaaaaa
aaaaaaaaaaaaaaaaadFFFFFPXsFnFFaaFFaadFPaFaaaaaaasPaaFFFFFXFaaasaaasoaaassaavakFkkPFPPFaaaaFFFFaaFFFFFaaaFaaaFFFaaadFFFXFFdaFFaoFFFFFFFFFFaaaaaaaaaaaaa
aaaaaaaaaaaaaaaaaFFPFdXFFFFFsaaaFFoaFPFaaaaaoaFaaakssanFFaaaaaakaIaosaaaoasaaksaoaaaFFFaaaFFFFaaFFFFFaaaFFaaFFFFaaFFFFFaaaaFFFFFFFFFFFFFFaaaaaaaaaaaaa
aaaaaaaaaaaaaaaaFFFFFFFdPFFasaaoaasaXsXaUaaaaaPaosaaFFFXFaaaaoaSoaaaaasaaskaaaFFFFaaFFaaaFFFFFaaaFFFFFaFFFaaFFFFaaFFFFFFaaaFFFFFPFFFFFFFaaaaaaaaaaaaaa
aaaaaaaaaaaaaaaaFFFFPFFFFXFFaUaaksFFFasgkaaaaaaaFaokFFFXFaoaaskaIaosFFFoaFaaoFFFFXFFaaaaaFadFFaaaFFFFFaFFFFaaFFFaaFFFFFFFaaaFaaFFFFFFFFaaaaaaaaaaaaaaa
aaaaaaaaaaaaaaaFFFFFFFFFFFUaaoaaaaaFFaaasaaaaaakaaaaFXaaUaakXFToaaaaFXFaaFFFFFdFFFXFaoaaFFFFFFFaaFFFFFaFFFFaaFFFaFFFFFFFFFaFFsaFFFFFFFaaaaaaaaaaaaaaaa
aaaaaaaaaaaaaaaFFFFFKFFXFaasaaskoaFFaaaakaaaaaFFFFFasaUaoaaaFFPsUnFFFPXFaFFFFFFFFaaaaaaaFaFFFFFaaaFFFFaFFFFFaaFFaFFFFFFFFdaFasoFFFPFFaaaaaaaaaaaaaaaaa
aaaaaaaaaaaaaaaFFFFFFPPFFaaagaaaUaFFkoakaaaaaaFKFFFaaUoaFXPdFFPFFdXFFFFFaaFFFaaaaaaaaaaaFaFFFFFFaaaFFFaFPdFFaaaFaFFFFFFFFFaFaFFFFFPPFaaaaaaaaaaaaaaaaa
aaaaaaaaaaaaaaaaFFFdFFFkaoaakXFsahUssaUSoaaaaaaaPPnFFdagFFFnFFFFFkFXPdFFoaFFFaaaaaaaaaaaFFFFFFFFaaaFFFFFFFFFFaaFFFFFFFFFFaaFaFFFFdFFFaaaaaaaaaaaaaaaaa
aaaaaaaaaaaaaaaaaFFFFFFaUaaaFFFUsoskUsaksaaaaaoaFFFXFFFPXFXFEnFakaaFFnFFaaaaaaaaaaaaaaaaFFaFFFFFFaaFFFFFFFFFFaaFFFFFFFFFaaaFFFFFFFFFaaaaaaaaaaaaaaaaaa
aaaaaaaaaaaaaaaaaaFFFFFaFkaaaaaaUoaoakakaaaaaaaaaFFagaXFFFFFFFFaaaaaXFEnFaaaaaaaaaaaaaaaFFaaFPdFFaaaFFFFFFFFFdaFFFFFFFFaaaaaFFXFXaaaaaaaaaaaaaaaaaaaaa
aaaaaaaaaaaaaaaaaaaFFFdFFsgakaakPXaaaakaFaaaaaaaaaaaksFFFFaaFFaaaaaaaaaaaaaaaaaaaaaaaaaaFFaPFFFFFFaaFFFPPPFPPaaaaFFFFFFaaaaaaFFFFaoaaaaaaaaaaaaaaaaaaa
aaaaaaaaaaaaaaaaaaaFFFFFFaasokoaPFsvkokaFaaaaaaaaaaaaaaFFaaaaaaaaaaaaaaaaaaaaaaaaaaaaaaaaaaFFFFFFFaaFFFFdFFFFaaaaFFFFFFaaaaaaaaaaaaaaaaaaaaaaaaaaaaaaa
aaaaaaaaaaaaaaaaaaaaFFFaaagaFskaIFaasaaaaaaaaaaaaaaaaaaaaaaaaaaaaaaaaaaaaaaaaaaaaaaaaaaaaaaFFFFFFFdaaFFFFFFFFFaaaaFFFFaaaaaaaaaaaaaaaaaaaaaaaaaaaaaaaa
aaaaaaaaaaaaaaaaaaaaFFFaaasaFaaasxPPaaosasndFFssaavFPFPPPFPPaaaaoaaaaasFFFFaFFFFFFaaaaaavFPFPPPFPPaaaFaFFXFFFFaaaaFFFFaaaaaaaaaaaaaaaaaaaaaaaaaaaaaaaa
aaaaaaaaaaaaaaaaaaaaaFFoaaaoaaoasaPFskakaFXFFFPaGsaFPXFdFFFFaaaasUUaaaaFFFFaFFFFFFFaaaaaaFPXFdFFFFaaaFaFFFXFFdaaaFFFFaaaaaaaaaaaaaaaaaaaaaaaaaaaaaaaaa
aaaaaaaaaaaaaaaaaaaaaFFFFFFXFFFFgIFFFaaagaPnFTssskaFFFFFFFFFFaaaaaosagaFFnFoaaFPdFFaaaaaaFFFFFFFFFFaaFaFFFFaaaaaFFFFaaaaaaaaaaaaaaaaaaaaaaaaaaaaaaaaaa
aaaaaaaaaaaaaaaaaaaaaaFFFFFXFFFFskjaakdkaPFPFPaaFaaoFFFFXFFFFaaaFakakaaXFFFaaPFFFFFFaaaaaoFFFFXFFFFaFFaFFFFFaaaFFFFFaaaaaaaaaaaaaaaaaaaaaaaaaaaaaaaaaa
aaaaaaaaaaaaaaaaaaaaaFFFFFFFXXFFdnFkaNFFakaaaaoaaaaaadFFFXFFdaaaFPaakkaasaaasFFFFFFFaaaaaaadFFFXFFdaFFaFFFFFFaaaaFFaaaaaaaaaaaaaaaaaaaaaaaaaaaaaaaaaaa
aaaaaaaaaaaaaaaaaaaaaFFFFFFFdFXFFFFZaFFFssoFaaFaaaFaaFFFFFaaaaaaaFaaaPIFkIasFFFFFFFFdaaaFaaFFFFFaaaaFFaFFFFFFFaaaFaaaaaaaaaaaaaaaaaaaaaaaaaaaaaaaaaaaa
aaaaaaaaaaaaaaaaaaaaFFFFFFFFFFXXFFFkkkPaoassaaaaaFFFFFFFFFFaaaaaasndFFssaavFPFPPPFPPaaaaFFFFFFFFFaaaFFaFFFFFFdaaaaaaaaaaaaaaaaaaaaaaaaaaaaaaaaaaaaaaaa
aaaaaaaaaaaaaaaaaaaFFFFFFFFFFFFnFFUkasUaasskaaaoaFFAFFFFFFFFaaaaaFXFFFPaGsaFPXFdFFFFaaaaFAFFFFFFFFaaFaaFFFFFFFaaaaaaaaaaaaaaaaaaaaaaaaaaaaaaaaaaaaaaaa
aaaaaaaaaaaaaaaaaaaFFFFFFFFFFFFFoaaasaaoaasaaaFaaFFFFFFFFFFFFaaagaPnFTssskaFFFFFFFFFFaaaFFFFFFFFFFFaaaaFFFFFFaaaaaaaaaaaaaaaaaaaaaaaaaaaaaaaaaaaaaaaaa
aaaaaaaaaaaaaaaaaaaaFFFFFFFFFFdFkssFvaaUasaaoaaaaFFFFFFFFFFFdaaaaPFPFPaaFaaoFFFFXFFFFaaaFFFFFFFFFFdaaaaFFFFFaaaaaaaaaaaaaaaaaaaaaaaaaaaaaaaaaaaaaaaaaa
aaaaaaaaaaaaaaaaaaaaaFFFFdFFFFFFaasaakaUaaaPFFFFdFFFFFFFFFFFFaaaakaaaaoaaaaaadFFFXFFdaaaFFFFFFFFFFFaaaaFFFFaaaaaaaaaaaaaaaaaaaaaaaaaaaaaaaaaaaaaaaaaaa
aaaaaaaaaaaaaaaaaaaaaaFFFFFFYFnaFaaaasFksoFFFFFFFFFFFFFFFFFFaaaassoFaaFaaaFaaFFFFFaaaaaaFFFFFFFFFFaaaaaFFFFaaaaaaaaaaaaaaaaaaaaaaaaaaaaaaaaaaaaaaaaaaa
aaaaaaaaaaaaaaaaaaaaaaaaFFFFFFFaaaFsaaasksaFFFFFFFFFFFFFFFFaaaaaoassaaaaaFFFFFFFFFFaaaaaFFFFFFFFFaaaaaaFFFFaaaaaaaaaaaaaaaaaaaaaaaaaaaaaaaaaaaaaaaaaaa
aaaaaaaaaaaaaaaaaaaaaaaaFdFsaaFoFaaZaasavaFFFPFFFFFFFFFFFFaaaaaaasskaaaoaFFAFFFFFFFFaaaaFFFFFFFFaaaaaaaFFFaaaaaaaaaaaaaaaaaaaaaaaaaaaaaaaaaaaaaaaaaaaa
aaaaaaaaaaaaaaaaaaaaaaaFXaaaaaFaaFkasaakaaaaaakFFFFFFFFFFFaaaaaaaasaaaFaaFFFFFFFFFFFFaaaFFFFFFFFaaaaaaaFFFaaaaaaaaaaaaaaaaaaaaaaaaaaaaaaaaaaaaaaaaaaaa
aaaaaaaaaaaaaaaaaaaFFXaFFfFaoaFaasaaadaakaaaoaaFFFFFFFFFFFaaaaaaasaaoaaaaFFFFFFFFFFFdaaaFFFFFFFFaaaaaaaFFaaaaaaaaaaaaaaaaaaaaaaaaaaaaaaaaaaaaaaaaaaaaa
aaaaaaaaaaaaaaaassFFFaoakssaFsaasavaaaaaaasaaaoFFFFFFFFFFaaaaaaaaaaPFFFFdFFFFQQQQQFFFaaaFFFFFFFaaaaaaaaFaaaaaaaaaaaaaaaaaaaaaaaaaaaaaaaaaaaaaaaaaaaaaa
aaaaaaaaaaaaaaaFFFssaaaaassaaaagskaaaaaakaagFFFFFFFFFFFFFaaaaaaasoFFFFFFFFFFFQFFFFFFaaaaFFFFFFFaaaaaaaaaaaaaaaaaaaaaaaaaaaaaaaaaaaaaaaaaaaaaaaaaaaaaaa
aaaaaaaaaaaaaaaFFFaaaakaaaFassaakFFaaaoaaoaaXFFFPFFFFFFFaaaaaoaaksaFFFFFFFFFQFFFFFFaaaaaFFFFFFaaaaaaaaaaaaaaaaaaaaaaaaaaaaaaaaaaaaaaaaaaaaaaaaaaaaaaaa
aaaaaaaaaaaaaaFFFFaaoaksdsasossvFaaagaFFFkaasaaFFFFFFFFaaaaaaaaavaFFFPFFFFFQFFFQFFaaaaaaFFFFFaaaaaaaaaaaaaaaaaaaaaaaaaaaaaaaaaaaaaaaaaaaaaaaaaaaaaaaaa
aaaaaaaaaaaaaaFFFFoaaaaaaaFasakaaFFaaaXFFaaoasaFFFFFFFaaaaaaaaaaaaaaaakFFFQQFFQFFFaaaaaaFFFFaaaaaaaaaaaaaaaaaaaaaaaaaaaaaaaaaaaaaaaaaaaaaaaaaaaaaaaaaa
aaaaaaaaaaaaaaFFFFwPFFFoaaaSaaaaaaaaaFFFXaaaasoFFFPFFaaaaaaaaaaakaaaoaaFFFFFFQFFFFaaaaaaPFFaaaaaaaaaaaaaaaaaaaaaaaaaaaaaaaaaaaaaaaaaaaaaaaaaaaaaaaaaaa
aaaaaaaaaaaaaaFFFFPFFFFFXFXXFXFXFFdaaFFaaFXFlFFFFFPPFaaaaaaaaaaaaasaaaoFFFFFQQFFFaaaaaaaPPFaaaaaaaaaaaaaaaaaaaaaaaaaaaaaaaaaaaaaaaaaaaaaaaaaaaaaaaaaaa
aaaaaaaaaaaaaaaFFFFFFFFlFFFFFFdFFdXaoaaFaFFFFFFFFdFFFaaaaaaaoaaakaagFFFFFFFFFFFFFaaaaaaaFFFaaaaaaaaaaaaaaaaaaaaaaaaaaaaaaaaaaaaaaaaaaaaaaaaaaaaaaaaaaa
aaaaaaaaaaaaaaaaFdFFFFFFFFFFFFFFFFFFFFsoaXFFXFFFFFFFaaaaaaaaaaaaaoaaXFFFPFFFFFFFaaaaaaaaFFaaaaaaaaaaaaaaaaaaaaaaaaaaaaaaaaaaaaaaaaaaaaaaaaaaaaaaaaaaaa
aaaaaaaaaaaaaaaaFFFFFFFFFFFdFFFFFFFFFFaaaaaaFFXFXaaaaaaaaaoaaaaaFkaasaaFFFFFFFFaaaaaaaaaaaaaaaaaaaaaaaaaaaaaaaaaaaaaaaaaaaaaaaaaaaaaaaaaaaaaaaaaaaaaaa
aaaaaaaaaaaaaaaaaaFFFdFFFFFFFFFFFFaaaaaaaaaoFFFFFaoaaaaaaaaaaaaaFaaoasaFFFFFFFaaaaaaaaaaoaaaaaaaaaaaaaaaaaaaaaaaaaaaaaaaaaaaaaaaaaaaaaaaaaaaaaaaaaaaaa
aaaaaaaaaaaaaaaaaaaaaFFFFFFFFFaaoaaaaaaaaaaaaaaaaaaaaaaaaaaaaaaaXaaaasoFFFPFFaaaaaaaaaaaaaaaaaaaaaaaaaaaaaaaaaaaaaaaaaaaaaaaaaaaaaaaaaaaaaaaaaaaaaaaaa
aaaaaaaaaaaaaaaaaaaaaaaaaaaaaaaaaaaaaaFFFFPFFFFFXFXXFXFXFFdaaFFaaFXFlFFFFFPPFaaaaaaaaaaaaaaaaaaaaaaaaaaaaaaaaaaaaaaaaaaaaaaaaaaaaaaaaaaaaaaaaaaaaaaaaa
aaaaaaaaaaaaaaaaaaaaaaaaaaaaaaaaaaaaaaaFFFFFFFFlFFFFFFdFFdXaoaaFaFFFFFFFFdFFFaaaaaaaaaaaaaaaaaaaaaaaaaaaaaaaaaaaaaaaaaaaaaaaaaaaaaaaaaaaaaaaaaaaaaaaaa
aaaaaaaaaaaaaaaaaaaaaaaaaaaaaaaaaaaaaaaaFdFFFFFFFFFFFFFFFFFFFFsoaXFFXFFFFFFFaaaaaaaaaaaaaaaaaaaaaaaaaaaaaaaaaaaaaaaaaaaaaaaaaaaaaaaaaaaaaaaaaaaaaaaaaa
aaaaaaaaaaaaaaaaaaaaaaaaaaaaaaaaaaaaaaaaFFFFFFFFFFFdFFFFFFFFFFaaaaaaFFXFXaaaaaaaaaaaaaaaaaaaaaaaaaaaaaaaaaaaaaaaaaaaaaaaaaaaaaaaaaaaaaaaaaaaaaaaaaaaaa
aaaaaaaaaaaaaaaaaaaaaaaaaaaaaaaaaaaaaaaaaaFFFdFFFFFFFFFFFFaaaaaaaaaoFFFFFaoaaaaaaaaaaaaaaaaaaaaaaaaaaaaaaaaaaaaaaaaaaaaaaaaaaaaaaaaaaaaaaaaaaaaaaaaaaa
aaaaaaaaaaaaaaaaaaaaaaaaaaaaaaaaaaaaaaaaaaaaaFFFFFFFFFaaoaaaaaaaaaaaaaaaaaaaaaaaaaaaaaaaaaaaaaaaaaaaaaaaaaaaaaaaaaaaaaaaaaaaaaaaaaaaaaaaaaaaaaaaaaaaaa
aaaaaaaaaaaaaaaaaaaaaaaaaaaaaaaaaaaaaaaaaaaaaaaaaaaaaaaaaaaaaaaaaaaaaaaaaaaaaaaaaaaaaaaaaaaaaaaaaaaaaaaaaaaaaaaaaaaaaaaaaaaaaaaaaaaaaaaaaaaaaaaaaaaaaa
aaaaaaaaaaaaaaaaaaaaaaaaaaaaaaaaaaaaaaaaaaaaaaaaaaaaaaaaaaaaaaaaaaaaaaaaaaaaaaaaaaaaaaaaaaaaaaaaaaaaaaaaaaaaaaaaaaaaaaaaaaaaaaaaaaaaaaaaaaaaaaaaaaaaaa
aaaaaaaaaaaaaaaaaaaaaaaaaaaaaaaaaaaaaaaaaaaaaaaaaaaaaaaaaaaaaaaaaaaaaaaaaaaaaaaaaaaaaaaaaaaaaaaaaaaaaaaaaaaaaaaaaaaaaaaaaaaaaaaaaaaaaaaaaaaaaaaaaaaaaa
aaaaaaaaaaaaaaaaaaaaaaaaaaaaaaaaaaaaaaaaaaaaaaaaaaaaaaaaaaaaaaaaaaaaaaaaaaaaaaaaaaaaaaaaaaaaaaaaaaaaaaaaaaaaaaaaaaaaaaaaaaaaaaaaaaaaaaaaaaaaaaaaaaaaaa
aaaaaaaaaaaaaaaaaaaaaaaaaaaaaaaaaaaaaaaaaaaaaaaaaaaaaaaaaaaaaaaaaaaaaaaaaaaaaaaaaaaaaaaaaaaaaaaaaaaaaaaaaaaaaaaaaaaaaaaaaaaaaaaaaaaaaaaaaaaaaaaaaaaaaa
aaaaaaaaaaaaaaaaaaaaaaaaaaaaaaaaaaaaaaaaaaaaaaaaaaaaaaaaaaaaaaaaaaaaaaaaaaaaaaaaaaaaaaaaaaaaaaaaaaaaaaaaaaaaaaaaaaaaaaaaaaaaaaaaaaaaaaaaaaaaaaaaaaaaaa
aaaaaaaaaaaaaaaaaaaaaaaaaaaaaaaaaaaaaaaaaaaaaaaaaaaaaaaaaaaaaaaaaaaaaaaaaaaaaaaaaaaaaaaaaaaaaaaaaaaaaaaaaaaaaaaaaaaaaaaaaaaaaaaaaaaaaaaaaaaaaaaaaaaaaa
"}
