"an" = (/obj/structure/cable{d1 = 4; d2 = 8; icon_state = "4-8"},/obj/effect/decal/cleanable/dirt,/obj/structure/cable{d1 = 1; d2 = 4; icon_state = "1-4"},/turf/simulated/floor/tiled/white,/area/outpost/research/lab)
"aE" = (/obj/machinery/light{dir = 8},/obj/effect/floor_decal/spline/fancy,/obj/effect/floor_decal/spline/fancy,/obj/effect/floor_decal/spline/fancy,/turf/simulated/floor/tiled/white,/area/outpost/research/lab)
"aQ" = (/obj/effect/floor_decal/corner/purple{dir = 5},/obj/structure/cable{d1 = 1; d2 = 4; dir = 4; icon_state = "1-4"},/turf/simulated/floor/tiled/white,/area/outpost/research/lab)
"by" = (/obj/structure/bed,/obj/effect/decal/cleanable/blood/gibs/xeno,/turf/simulated/floor/reinforced,/area/outpost/research/lab)
"bG" = (/turf/simulated/floor/asteroid,/area/space)
"dD" = (/obj/effect/floor_decal/industrial/warning{dir = 4},/turf/simulated/floor/tiled/white,/area/outpost/research/lab)
"dO" = (/obj/structure/window_frame/grille/rglass,/turf/simulated/floor/plating,/area/outpost/research/lab)
"eU" = (/turf/simulated/floor/reinforced,/area/outpost/research/lab)
"fp" = (/obj/effect/floor_decal/spline/fancy{dir = 1},/obj/machinery/power/solar_control,/obj/structure/cable{d2 = 2; icon_state = "0-2"},/turf/simulated/floor/tiled/white,/area/outpost/research/lab)
"fS" = (/turf/simulated/mineral,/area/space)
"gh" = (/obj/machinery/power/solar,/obj/structure/cable{d2 = 2; icon_state = "0-2"; pixel_y = 0},/turf/simulated/floor/asteroid,/area/space)
"gp" = (/obj/machinery/artifact_analyser,/turf/simulated/floor/reinforced,/area/outpost/research/lab)
"id" = (/obj/structure/cable{d1 = 1; d2 = 2; dir = 4; icon_state = "1-2"},/turf/simulated/floor/tiled/white,/area/outpost/research/lab)
"ip" = (/obj/machinery/door/airlock/research{icon = 'icons/obj/doors/doorsci.dmi'; name = "Anomalous Materials"; req_access = list(65)},/obj/structure/cable{d1 = 1; d2 = 2; icon_state = "1-2"},/turf/simulated/floor/tiled/white,/area/outpost/research/lab)
"iN" = (/obj/structure/table/standard,/obj/item/paper_bin{pixel_y = 8},/obj/item/pen,/turf/simulated/floor/tiled/white,/area/outpost/research/lab)
"ja" = (/turf/simulated/wall,/area/outpost/research/lab)
"kE" = (/obj/effect/floor_decal/corner/purple{dir = 9},/obj/item/device/radio/intercom{dir = 4; pixel_x = -22},/turf/simulated/floor/tiled/white,/area/outpost/research/lab)
"md" = (/obj/machinery/power/apc/critical{dir = 1; name = "north bump"; pixel_y = 24},/obj/structure/table/rack,/obj/item/defibrillator/compact/loaded,/obj/item/cell/high{layer = 4; pixel_x = -5; pixel_y = 12},/obj/effect/floor_decal/corner/beige/three_quarters{dir = 1},/obj/structure/cable{d2 = 2; icon_state = "0-2"; pixel_y = 0},/obj/effect/decal/cleanable/dirt,/turf/simulated/floor/tiled/white/rough,/area/outpost/research/lab)
"nN" = (/obj/structure/cable{d1 = 2; d2 = 4; icon_state = "2-4"},/obj/effect/decal/cleanable/dirt,/turf/simulated/floor/tiled/white/rough,/area/outpost/research/lab)
"nT" = (/obj/structure/bed/chair{dir = 8},/obj/item/device/radio/intercom{pixel_y = 22},/turf/simulated/floor/reinforced,/area/outpost/research/lab)
"oE" = (/obj/structure/cable{d2 = 8; icon_state = "0-8"},/obj/machinery/power/terminal{dir = 4},/obj/effect/floor_decal/spline/fancy,/turf/simulated/floor/tiled/white,/area/outpost/research/lab)
"oO" = (/obj/structure/cable{d1 = 4; d2 = 8; icon_state = "4-8"},/turf/simulated/floor/tiled/white/rough,/area/outpost/research/lab)
"pd" = (/obj/structure/cable{d1 = 4; d2 = 8; icon_state = "4-8"},/obj/structure/cable{d1 = 1; d2 = 4; icon_state = "1-4"},/obj/machinery/light,/obj/effect/floor_decal/spline/fancy,/turf/simulated/floor/tiled/white,/area/outpost/research/lab)
"pC" = (/obj/structure/cable{d1 = 1; d2 = 2; icon_state = "1-2"},/obj/machinery/door/airlock/external{id_tag = "abadon-airlock"; name = "Access Airlock"; req_access = list(65)},/turf/simulated/floor/plating,/area/outpost/research/lab)
"qH" = (/obj/machinery/door/airlock/security,/obj/structure/cable{d1 = 1; d2 = 2; icon_state = "1-2"},/turf/simulated/floor/tiled/white,/area/outpost/research/lab)
"qP" = (/obj/structure/cable{d1 = 1; d2 = 4; dir = 1; icon_state = "1-4"},/turf/simulated/floor/asteroid,/area/space)
"ra" = (/obj/structure/bed/chair/office/dark{dir = 8},/obj/effect/floor_decal/corner/red{dir = 5},/obj/item/device/radio/intercom/department/security{pixel_y = 22},/obj/structure/cable{d1 = 2; d2 = 4; icon_state = "2-4"},/obj/machinery/light{dir = 1},/turf/simulated/floor/tiled/white,/area/outpost/research/lab)
"rd" = (/obj/machinery/power/apc/critical{dir = 1; name = "north bump"; pixel_y = 24},/obj/structure/cable{d2 = 4; icon_state = "0-4"},/turf/simulated/floor/tiled/white,/area/outpost/research/lab)
"rD" = (/obj/machinery/power/apc/critical{dir = 1; name = "north bump"; pixel_y = 24},/obj/structure/cable{d2 = 2; icon_state = "0-2"; pixel_y = 0},/obj/effect/floor_decal/spline/fancy{dir = 1},/turf/simulated/floor/tiled/white,/area/outpost/research/lab)
"rO" = (/obj/structure/girder,/turf/simulated/floor/plating,/area/outpost/research/lab)
"sx" = (/obj/effect/decal/cleanable/dirt,/obj/effect/decal/cleanable/dirt,/turf/simulated/floor/tiled/white,/area/outpost/research/lab)
"sJ" = (/obj/machinery/artifact_scanpad,/turf/simulated/floor/reinforced,/area/outpost/research/lab)
"sT" = (/obj/structure/girder,/turf/simulated/floor/asteroid,/area/outpost/research/lab)
"to" = (/obj/structure/cable{d1 = 1; d2 = 2; icon_state = "1-2"},/obj/effect/decal/cleanable/dirt,/obj/effect/floor_decal/spline/fancy{dir = 1},/turf/simulated/floor/tiled/white,/area/outpost/research/lab)
"tI" = (/mob/living/simple_animal/hostile/giant_spider/midwife,/turf/simulated/floor/reinforced,/area/outpost/research/lab)
"tR" = (/obj/machinery/embedded_controller/radio/airlock/airlock_controller{dir = 8; frequency = 1381; id_tag = "anom_ex"; pixel_x = 25; req_access = list(47,10,1); tag_airpump = "anom_pump"; tag_chamber_sensor = "anom_sensor"; tag_exterior_door = "anom_exterior"; tag_interior_door = "anom_interior"},/obj/effect/floor_decal/industrial/warning{dir = 8},/obj/effect/floor_decal/industrial/warning{dir = 4},/turf/simulated/floor/plating,/area/outpost/research/lab)
"tZ" = (/obj/effect/floor_decal/industrial/warning{dir = 8},/turf/simulated/floor/tiled/white,/area/outpost/research/lab)
"uk" = (/obj/structure/cable{d1 = 1; d2 = 4; icon_state = "1-4"},/turf/simulated/floor/asteroid,/area/space)
"uF" = (/obj/structure/cable{d1 = 4; d2 = 8; icon_state = "4-8"},/obj/structure/cable{d1 = 2; d2 = 4; icon_state = "2-4"},/turf/simulated/floor/tiled/white,/area/outpost/research/lab)
"uZ" = (/obj/structure/closet/secure_closet/security,/obj/effect/floor_decal/industrial/outline/red,/obj/item/storage/secure/guncase/security,/obj/machinery/light{dir = 4; icon_state = "tube1"},/turf/simulated/floor/tiled/dark/rough,/area/outpost/research/lab)
"vr" = (/obj/structure/cable{d1 = 1; d2 = 4; icon_state = "1-4"},/obj/structure/cable{d1 = 1; d2 = 2; dir = 4; icon_state = "1-2"},/turf/simulated/floor/asteroid,/area/space)
"vx" = (/obj/machinery/access_button/airlock_exterior{pixel_y = 29},/turf/simulated/floor/asteroid,/area/space)
"wj" = (/obj/structure/cable{d1 = 1; d2 = 2; icon_state = "1-2"},/obj/effect/floor_decal/industrial/warning{dir = 8},/obj/effect/floor_decal/industrial/warning{dir = 4},/turf/simulated/floor/plating,/area/outpost/research/lab)
"yS" = (/obj/structure/cable{d1 = 1; d2 = 2; dir = 4; icon_state = "1-2"},/obj/structure/cable{d1 = 1; d2 = 4; icon_state = "1-4"},/turf/simulated/floor/tiled/white,/area/outpost/research/lab)
"zl" = (/obj/structure/table/standard,/obj/effect/floor_decal/corner/red{dir = 5},/obj/item/device/radio/off,/turf/simulated/floor/tiled/white,/area/outpost/research/lab)
"zp" = (/obj/structure/cable{d1 = 1; d2 = 8; icon_state = "1-8"},/turf/simulated/floor/asteroid,/area/space)
"zq" = (/obj/structure/window_frame/broken,/obj/item/material/shard,/obj/item/arrow/rod{pixel_y = -6},/obj/item/arrow/rod,/turf/simulated/floor/plating,/area/outpost/research/lab)
"AH" = (/obj/effect/floor_decal/corner/beige/three_quarters{dir = 8},/obj/structure/closet/secure_closet/paramedic,/obj/structure/cable/green{d2 = 2; icon_state = "0-2"},/obj/item/storage/box/syringegun,/obj/item/gun/launcher/syringe,/obj/machinery/atmospherics/unary/vent_scrubber/on,/obj/machinery/light/small/hl{dir = 1},/turf/simulated/floor/tiled/white/rough,/area/outpost/research/lab)
"AR" = (/obj/effect/floor_decal/corner/purple{dir = 9},/obj/machinery/light{dir = 8},/turf/simulated/floor/tiled/white,/area/outpost/research/lab)
"Bx" = (/obj/structure/window/reinforced{dir = 1},/obj/structure/window/reinforced{dir = 4},/turf/simulated/floor/reinforced,/area/outpost/research/lab)
"BG" = (/obj/structure/closet/secure_closet/security,/obj/effect/floor_decal/industrial/outline/red,/obj/item/storage/secure/guncase/security,/turf/simulated/floor/tiled/dark/rough,/area/outpost/research/lab)
"Cf" = (/obj/structure/cable{d1 = 1; d2 = 4; icon_state = "1-4"},/obj/effect/floor_decal/spline/fancy,/obj/effect/floor_decal/spline/fancy{dir = 8},/turf/simulated/floor/tiled/white,/area/outpost/research/lab)
"Ct" = (/obj/machinery/light{dir = 8},/obj/effect/decal/cleanable/generic,/turf/simulated/floor/reinforced,/area/outpost/research/lab)
"CV" = (/obj/machinery/power/tracker,/obj/structure/cable{d2 = 8; icon_state = "0-8"},/turf/simulated/floor/asteroid,/area/space)
"Da" = (/obj/machinery/power/smes/buildable{RCon_tag = "Substation - Cargo"; input_level = 250000; input_level_max = 250000; output_level = 250000; output_level_max = 250000},/obj/effect/floor_decal/spline/fancy{dir = 4},/turf/simulated/floor/tiled/white,/area/outpost/research/lab)
"DB" = (/obj/effect/decal/cleanable/dirt,/turf/simulated/floor/tiled/white,/area/outpost/research/lab)
"DT" = (/obj/effect/floor_decal/corner/beige{dir = 6},/obj/machinery/light/small/hl{dir = 4},/obj/structure/cable{d1 = 1; d2 = 4; dir = 4; icon_state = "1-4"},/turf/simulated/floor/tiled/white/rough,/area/outpost/research/lab)
"EC" = (/obj/machinery/door/airlock/external{frequency = 1380; id_tag = "first_outer"; locked = 1},/turf/simulated/floor/plating,/area/outpost/research/lab)
"Fg" = (/obj/structure/window_frame/grille/rglass,/obj/machinery/door/blast/regular/open{dir = 8; id = "abadoned-isol"},/turf/simulated/floor/reinforced,/area/outpost/research/lab)
"FI" = (/obj/effect/floor_decal/corner/purple{dir = 5},/obj/machinery/button/remote/blast_door{dir = 4; id = "abadoned-isol"; pixel_x = 26},/turf/simulated/floor/tiled/white,/area/outpost/research/lab)
"FL" = (/obj/structure/cable{d1 = 1; d2 = 2; icon_state = "1-2"},/obj/structure/cable{d1 = 1; d2 = 4; icon_state = "1-4"},/obj/effect/floor_decal/spline/fancy,/turf/simulated/floor/tiled/white,/area/outpost/research/lab)
"FR" = (/obj/machinery/light{dir = 1},/obj/effect/floor_decal/spline/fancy{dir = 1},/turf/simulated/floor/tiled/white,/area/outpost/research/lab)
"Hz" = (/obj/effect/floor_decal/corner/purple{dir = 6},/obj/machinery/light{dir = 4; icon_state = "tube1"},/turf/simulated/floor/tiled/white,/area/outpost/research/lab)
"Ir" = (/obj/machinery/door/airlock/external{id_tag = "abadon-airlock"; name = "Access Airlock"; req_access = list(65)},/turf/simulated/floor/reinforced,/area/outpost/research/lab)
"IF" = (/obj/effect/floor_decal/corner/purple{dir = 6},/obj/item/target/alien,/turf/simulated/floor/tiled/white,/area/outpost/research/lab)
"IX" = (/obj/effect/floor_decal/industrial/warning{dir = 4},/obj/effect/decal/cleanable/blood/gibs/robot,/obj/effect/decal/cleanable/blood/oil,/turf/simulated/floor/tiled/white,/area/outpost/research/lab)
"JI" = (/obj/structure/table/standard,/obj/item/device/flashlight/lamp,/obj/machinery/light{dir = 4; icon_state = "tube1"},/turf/simulated/floor/reinforced,/area/outpost/research/lab)
"Li" = (/obj/structure/cable{d1 = 1; d2 = 2; icon_state = "1-2"},/turf/simulated/floor/asteroid,/area/space)
"Lv" = (/obj/structure/window_frame/rglass,/obj/effect/decal/cleanable/dirt,/turf/simulated/floor/plating,/area/outpost/research/lab)
"Ns" = (/obj/effect/floor_decal/corner/red{dir = 6},/obj/effect/decal/cleanable/dirt,/turf/simulated/floor/tiled/white,/area/outpost/research/lab)
"Ny" = (/obj/structure/cable{d1 = 1; d2 = 4; dir = 4; icon_state = "1-4"},/obj/structure/cable{d1 = 1; d2 = 2; dir = 4; icon_state = "1-2"},/turf/simulated/floor/asteroid,/area/space)
"Ob" = (/obj/machinery/door/airlock/research{icon = 'icons/obj/doors/doorsci.dmi'; name = "Anomalous Materials"; req_access = list(65)},/obj/structure/cable{d1 = 1; d2 = 2; dir = 4; icon_state = "1-2"},/turf/simulated/floor/tiled/white,/area/outpost/research/lab)
"OA" = (/obj/structure/cable{d1 = 1; d2 = 4; dir = 1; icon_state = "1-4"},/obj/structure/cable{d1 = 2; d2 = 4; icon_state = "2-4"},/turf/simulated/floor/asteroid,/area/space)
"PJ" = (/obj/item/device/radio/intercom{dir = 8; pixel_x = 22},/obj/structure/cable{d1 = 1; d2 = 4; dir = 4; icon_state = "1-4"},/obj/effect/floor_decal/industrial/warning{dir = 1},/obj/machinery/light{dir = 4; icon_state = "tube1"},/obj/effect/floor_decal/asteroid,/obj/effect/floor_decal/spline/fancy{dir = 4},/turf/simulated/floor/tiled/white,/area/outpost/research/lab)
"Qg" = (/obj/structure/window_frame/rglass,/turf/simulated/floor/plating,/area/outpost/research/lab)
"Qv" = (/obj/structure/cable{d1 = 1; d2 = 2; icon_state = "1-2"},/obj/structure/cable{d1 = 1; d2 = 4; dir = 1; icon_state = "1-4"},/obj/structure/cable{d1 = 2; d2 = 4; icon_state = "2-4"},/turf/simulated/floor/asteroid,/area/space)
"QB" = (/turf/simulated/floor/tiled/white,/area/outpost/research/lab)
"QU" = (/obj/structure/cable{d1 = 1; d2 = 2; icon_state = "1-2"},/obj/effect/decal/cleanable/dirt,/turf/simulated/floor/tiled/white,/area/outpost/research/lab)
"Ra" = (/obj/structure/cable{d1 = 1; d2 = 2; icon_state = "1-2"},/obj/machinery/door/airlock/external/bolted_open,/turf/simulated/floor/plating,/area/outpost/research/lab)
"Rt" = (/obj/structure/cable{d1 = 4; d2 = 8; icon_state = "4-8"},/obj/effect/floor_decal/spline/fancy,/turf/simulated/floor/tiled/white,/area/outpost/research/lab)
"RZ" = (/obj/effect/decal/cleanable/dirt,/obj/machinery/light,/turf/simulated/floor/tiled/white,/area/outpost/research/lab)
"Sg" = (/obj/machinery/door/airlock/external{frequency = 1380; id_tag = "first_inner"; locked = 1},/turf/simulated/floor/plating,/area/outpost/research/lab)
"Sh" = (/obj/effect/decal/cleanable/ash,/turf/simulated/floor/reinforced,/area/outpost/research/lab)
"So" = (/obj/structure/closet/secure_closet/medical3,/obj/item/device/hudmatrix/medical,/obj/item/device/hudmatrix/medical,/obj/item/device/radio/headset/headset_med,/obj/item/storage/belt/medical,/obj/item/storage/belt/medical,/obj/item/storage/belt/medical,/obj/item/clothing/glasses/hud/one_eyed/oneye/medical,/obj/item/clothing/glasses/hud/one_eyed/oneye/medical,/obj/item/clothing/glasses/hud/one_eyed/oneye/medical,/obj/item/clothing/glasses/hud/standard/medical,/obj/item/clothing/glasses/hud/standard/medical,/obj/machinery/camera/network/medbay{c_tag = "Medbay Secondary Storage"; dir = 8},/obj/item/device/flashlight/pen,/obj/item/clothing/accessory/stethoscope,/obj/machinery/light/small/hl{dir = 1},/obj/effect/floor_decal/corner/beige{dir = 5},/turf/simulated/floor/tiled/white/rough,/area/outpost/research/lab)
"SX" = (/obj/effect/floor_decal/industrial/warning,/turf/simulated/wall,/area/outpost/research/lab)
"Tv" = (/obj/structure/cable{d1 = 4; d2 = 8; icon_state = "4-8"},/obj/structure/cable{d1 = 1; d2 = 4; icon_state = "1-4"},/obj/effect/decal/cleanable/dirt,/turf/simulated/floor/tiled/white,/area/outpost/research/lab)
"TT" = (/obj/machinery/access_button/airlock_exterior{frequency = 1381; pixel_y = -28; req_access = list(47,10,1); tag = "anom_ex"},/obj/effect/decal/cleanable/dirt,/obj/machinery/light,/turf/simulated/floor/tiled/white,/area/outpost/research/lab)
"Uw" = (/obj/effect/decal/cleanable/dirt,/obj/effect/floor_decal/spline/fancy,/obj/effect/floor_decal/spline/fancy,/turf/simulated/floor/tiled/white,/area/outpost/research/lab)
"UZ" = (/obj/effect/floor_decal/corner/red{dir = 6},/obj/effect/floor_decal/corner/red{dir = 5},/obj/machinery/power/apc/critical{dir = 1; name = "north bump"; pixel_y = 24},/obj/structure/cable{d2 = 8; icon_state = "0-8"},/turf/simulated/floor/tiled/white,/area/outpost/research/lab)
"Wv" = (/obj/effect/decal/cleanable/dirt,/obj/machinery/light{dir = 1},/obj/item/storage/toolbox/mechanical,/obj/effect/floor_decal/spline/fancy{dir = 1},/obj/effect/floor_decal/spline/fancy{dir = 4},/turf/simulated/floor/tiled/white,/area/outpost/research/lab)
"WX" = (/obj/effect/gibspawner/human,/turf/simulated/floor/tiled/white,/area/outpost/research/lab)
"Xz" = (/obj/structure/cable{d1 = 1; d2 = 4; dir = 1; icon_state = "1-4"},/obj/effect/gibspawner/human,/obj/effect/floor_decal/spline/fancy{dir = 1},/turf/simulated/floor/tiled/white,/area/outpost/research/lab)
"XA" = (/obj/effect/floor_decal/corner/purple{dir = 5},/obj/machinery/power/apc/critical{dir = 8; pixel_x = -28},/obj/structure/cable{d2 = 4; icon_state = "0-4"},/turf/simulated/floor/tiled/white,/area/outpost/research/lab)
"Yk" = (/obj/structure/cable{d1 = 4; d2 = 8; icon_state = "4-8"},/obj/effect/decal/cleanable/dirt,/turf/simulated/floor/tiled/white,/area/outpost/research/lab)
"YD" = (/obj/machinery/door/airlock/medical{icon = 'icons/obj/doors/doorviro.dmi'; name = "Secondary Storage"; req_access = list(66)},/obj/structure/cable{d1 = 1; d2 = 2; icon_state = "1-2"},/turf/simulated/floor/tiled/white/rough,/area/outpost/research/lab)
"ZS" = (/obj/structure/window/reinforced{dir = 4},/turf/simulated/floor/reinforced,/area/outpost/research/lab)

(1,1,1) = {"
fSfSfSfSfSfSfSfSfSfSfSfSbGghghbGghghbGbG
fSbGfSfSfSfSfSfSfSfSfSfSbGukvrOANyNyqPbG
fSbGbGfSfSfSfSfSfSfSbGbGbGghghLighghLibG
bGbGbGbGbGbGbGbGbGbGbGbGbGukvrQvNyNyQvCV
bGbGbGjadOjajadOjajaQgjajaghghLighghLibG
bGbGbGdOzlraUZBGjaAHSomdjaukvrQvNyNyzpbG
bGbGbGdOiNQUNsuZjanNoODTjabGjaRajabGbGbG
bGbGbGjajaqHjajajaYDjarOjajajawjsTbGbGbG
bGbGbGQgrdySidObXztoFRfprDWvjapCjabGbGbG
bGbGbGLvTTWXRZrOCfpdRtanTvuFYkPJjabGbGbG
bGbGbGjajaSgjajajajajaaEUwFLoEDajabGbGbG
bGbGbGbGjatRjabGbGbGjajazqipdOjajabGbGbG
bGbGbGbGjaECjabGjajajajaXAaQFISXjajajabG
bGfSbGbGbGbGvxbGjasJgpBxtZDBIXFgtInTjabG
bGfSfSbGbGbGbGbGjaCteUeUtZQBdDIreUJIjabG
fSfSfSfSbGbGbGbGjaeUShZStZsxdDFgeUbyjabG
fSfSfSfSfSbGbGbGjajajajaARDBHzjajajajabG
fSfSfSfSfSbGbGbGbGbGbGjakERZIFjabGbGbGbG
bGbGbGfSfSfSbGbGbGbGbGjajajajajabGbGbGbG
bGbGbGbGbGbGbGbGbGbGbGbGbGbGbGbGbGbGbGbG
"}
