"a" = (/turf/simulated/mineral,/area/mine/unexplored)
"b" = (/turf/unsimulated/wall/abductor{icon_state = "alien3"},/area/abductor_ship)
"d" = (/obj/item/clothing/mask/surgical,/turf/simulated/floor/plating,/area/polarplanet/medical/med_toilet)
"g" = (/obj/structure/inflatable/door,/turf/simulated/floor/asteroid,/area/polarplanet/medical/med_toilet)
"h" = (/obj/structure/rock,/turf/simulated/floor/asteroid,/area/polarplanet/medical/med_toilet)
"i" = (/turf/unsimulated/wall/abductor{icon_state = "alien20"},/area/polarplanet/medical/med_toilet)
"l" = (/turf/unsimulated/wall/abductor{icon_state = "alien22"},/area/polarplanet/medical/med_toilet)
"m" = (/obj/machinery/abductor/experiment{team_number = 1},/turf/simulated/floor/misc/abductor,/area/abductor_ship)
"n" = (/turf/unsimulated/wall/abductor{icon_state = "alien4"},/area/abductor_ship)
"p" = (/obj/structure/table,/obj/item/material/shard/plasma,/obj/item/material/shard/plasma,/turf/simulated/floor/misc/abductor,/area/abductor_ship)
"q" = (/turf/simulated/floor/plating,/area/polarplanet/medical/med_toilet)
"r" = (/obj/structure/bed/abductor,/turf/simulated/floor/misc/abductor,/area/abductor_ship)
"s" = (/turf/unsimulated/wall/abductor{icon_state = "alien9"},/area/polarplanet/medical/med_toilet)
"t" = (/turf/unsimulated/wall/abductor{icon_state = "alien17"},/area/abductor_ship)
"w" = (/turf/simulated/wall,/area/polarplanet/medical/med_toilet)
"y" = (/obj/structure/table/abductor,/obj/item/surgicaldrill/alien,/obj/item/circular_saw/alien,/obj/item/bonesetter/alien,/turf/simulated/floor/misc/abductor,/area/abductor_ship)
"z" = (/turf/simulated/floor/misc/abductor,/area/abductor_ship)
"A" = (/turf/unsimulated/wall/abductor{icon_state = "alien14"},/area/abductor_ship)
"B" = (/obj/machinery/organ_printer/flesh/mapped,/turf/simulated/floor/misc/abductor,/area/abductor_ship)
"C" = (/turf/unsimulated/wall/abductor{icon_state = "alien2"},/area/abductor_ship)
"D" = (/obj/structure/table/abductor,/obj/machinery/recharger,/obj/item/reagent_containers/vessel/beaker/noreact,/turf/simulated/floor/misc/abductor,/area/abductor_ship)
"E" = (/obj/item/hemostat/alien,/turf/simulated/floor/plating,/area/abductor_ship)
"G" = (/obj/item/clothing/gloves/latex/nitrile,/turf/simulated/floor/misc/abductor,/area/abductor_ship)
"H" = (/turf/simulated/floor/asteroid,/area/polarplanet/medical/med_toilet)
"I" = (/turf/unsimulated/wall/abductor{icon_state = "alien8"},/area/polarplanet/medical/med_toilet)
"J" = (/obj/machinery/abductor/console{team_number = 1},/turf/simulated/floor/misc/abductor,/area/abductor_ship)
"K" = (/turf/unsimulated/wall/abductor{icon_state = "alien13"},/area/polarplanet/medical/med_toilet)
"L" = (/obj/item/retractor/alien,/turf/simulated/floor/misc/abductor,/area/abductor_ship)
"M" = (/turf/unsimulated/wall/abductor{icon_state = "alien12"},/area/abductor_ship)
"O" = (/turf/unsimulated/wall/abductor{icon_state = "alien11"},/area/polarplanet/medical/med_toilet)
"P" = (/obj/machinery/optable/abductor,/obj/item/reagent_containers/spray/sterilizine,/turf/simulated/floor/misc/abductor,/area/abductor_ship)
"Q" = (/obj/machinery/abductor/gland_dispenser{team_number = 1},/turf/simulated/floor/misc/abductor,/area/abductor_ship)
"S" = (/obj/machinery/computer/camera_advanced/abductor{team_number = 1},/turf/simulated/floor/misc/abductor,/area/abductor_ship)
"T" = (/turf/unsimulated/wall/abductor{icon_state = "alien15"},/area/polarplanet/medical/med_toilet)
"U" = (/obj/effect/decal/cleanable/blood/oil,/turf/simulated/floor/asteroid,/area/polarplanet/medical/med_toilet)
"V" = (/turf/unsimulated/wall/abductor{icon_state = "alien21"},/area/polarplanet/medical/med_toilet)
"W" = (/turf/simulated/floor/misc/abductor,/area/polarplanet/medical/med_toilet)
"X" = (/obj/structure/table/abductor,/obj/item/cautery/alien,/obj/item/scalpel/alien,/obj/item/paper/guides/antag/abductor,/obj/item/bonegel/alien,/turf/simulated/floor/misc/abductor,/area/abductor_ship)
"Y" = (/obj/machinery/abductor/pad{team_number = 1},/turf/simulated/floor/misc/abductor,/area/polarplanet/medical/med_toilet)
"Z" = (/obj/item/FixOVein/alien,/turf/simulated/floor/misc/abductor,/area/abductor_ship)

(1,1,1) = {"
aaaaaaagaa
aaaaaawgaa
aaiVlwhHHa
aatmJYqHHa
aASGWdqTUa
aMpzPWDKHa
aaXEZLBOHa
aaaQyrIsaa
aaaCbnaaaa
aaaaaaaaaa
"}
