"a" = (/turf/simulated/floor/asteroid,/area/space)
"g" = (/turf/simulated/mineral,/area/space)
"l" = (/turf/simulated/shuttle/wall/corner/dark/ne,/area/space)
"o" = (/obj/structure/window_frame/broken,/obj/item/material/shard,/turf/simulated/floor/plating,/area/space)
"p" = (/turf/simulated/shuttle/wall/syndi{dir = 1; icon_state = "syndiwall_straight"},/area/space)
"F" = (/obj/structure/shuttle/engine/propulsion{icon_state = "propulsion_l"},/turf/simulated/floor/asteroid,/area/space)
"H" = (/obj/effect/decal/remains,/obj/item/gun/projectile/revolver{pixel_y = 10},/turf/simulated/floor/shuttle/darkred,/area/space)
"R" = (/obj/machinery/door/airlock/external/bolted_open,/turf/simulated/floor/shuttle/darkred,/area/space)
"V" = (/obj/item/modular_computer/console/preset/syndicate,/turf/simulated/floor/shuttle/darkred,/area/space)
"W" = (/mob/living/simple_animal/hostile/asteroid/goliath/alpha,/turf/simulated/floor/asteroid,/area/space)
"X" = (/turf/simulated/shuttle/wall/syndi{dir = 8; icon_state = "syndiwall_t"},/area/space)
"Z" = (/turf/simulated/shuttle/wall/syndi{dir = 4; icon_state = "syndiwall_t"},/area/space)

(1,1,1) = {"
gggggggggggg
gggggolggggg
ggagpVpggagg
ggagpHpagaag
aaagXRZagaag
aaaaFaFaaagg
aaaaaaaaaaag
aaaaaaaaaagg
aaaaWaaaagga
aaaaaaagagaa
aaaaaaaaagga
aaaaaaaaggaa
"}
