"a" = (/obj/effect/floor_decal/corner/brown/diagonal,/turf/simulated/floor/tiled/brown,/area/template_noop)
"e" = (/obj/effect/floor_decal/spline/fancy/wood{dir = 8},/obj/effect/floor_decal/spline/fancy/wood{dir = 4},/turf/simulated/floor/trim/darkwood,/area/template_noop)
"f" = (/obj/structure/table/darkwood_reinforced,/obj/effect/landmark/costume/random,/obj/item/clothing/under/dress/dress_saloon,/obj/item/clothing/head/hairflower,/obj/effect/floor_decal/spline/fancy/wood{dir = 8},/turf/simulated/floor/trim/darkwood,/area/template_noop)
"g" = (/obj/effect/floor_decal/spline/fancy/wood,/turf/simulated/floor/trim/darkwood,/area/template_noop)
"h" = (/obj/structure/table/darkwood_reinforced,/obj/effect/landmark/costume/random,/obj/effect/floor_decal/spline/fancy/wood{dir = 4},/turf/simulated/floor/trim/darkwood,/area/template_noop)
"j" = (/obj/effect/floor_decal/spline/fancy/wood{dir = 10},/turf/simulated/floor/trim/darkwood,/area/template_noop)
"m" = (/obj/effect/floor_decal/spline/fancy/wood/cee,/turf/simulated/floor/trim/darkwood,/area/template_noop)
"p" = (/obj/effect/floor_decal/stairs,/turf/simulated/floor/tiled,/area/template_noop)
"q" = (/obj/effect/floor_decal/spline/fancy/wood/corner,/obj/effect/floor_decal/spline/fancy/wood/corner{dir = 8},/turf/simulated/floor/trim/darkwood,/area/template_noop)
"t" = (/obj/effect/floor_decal/spline/fancy/wood{dir = 4},/obj/effect/floor_decal/spline/fancy/wood{dir = 8},/turf/simulated/floor/trim/darkwood,/area/template_noop)
"v" = (/obj/effect/floor_decal/corner/brown/diagonal,/obj/effect/floor_decal/spline/plain/corner,/turf/simulated/floor/tiled/brown,/area/template_noop)
"y" = (/obj/effect/floor_decal/corner/grey/full,/turf/simulated/floor/tiled,/area/template_noop)
"z" = (/obj/structure/table/darkwood_reinforced,/obj/effect/landmark/costume/random,/turf/simulated/floor/trim/darkwood,/area/template_noop)
"F" = (/obj/effect/floor_decal/corner/brown/diagonal,/obj/effect/floor_decal/spline/plain,/obj/structure/railing/darkwood,/turf/simulated/floor/tiled/brown,/area/template_noop)
"H" = (/obj/structure/bed/couch/right/sofa{dir = 1},/obj/structure/railing/darkwood,/turf/simulated/floor/trim/carpet/oldred,/area/template_noop)
"K" = (/obj/effect/floor_decal/corner/grey/full,/obj/structure/table/darkwood_reinforced,/obj/item/reagent_containers/food/popcorn{pixel_y = 16},/obj/item/reagent_containers/food/popcorn{pixel_y = 8; pixel_x = -6},/obj/item/reagent_containers/food/popcorn{pixel_y = 8; pixel_x = 6},/obj/item/reagent_containers/food/popcorn,/turf/simulated/floor/tiled,/area/template_noop)
"L" = (/obj/effect/floor_decal/corner/brown/diagonal,/obj/effect/floor_decal/spline/plain{dir = 6},/obj/structure/railing/darkwood,/turf/simulated/floor/tiled/brown,/area/template_noop)
"P" = (/obj/effect/floor_decal/corner/brown/diagonal,/obj/effect/floor_decal/spline/plain,/turf/simulated/floor/tiled/brown,/area/template_noop)
"Q" = (/obj/effect/floor_decal/spline/fancy/wood{dir = 6},/turf/simulated/floor/trim/darkwood,/area/template_noop)
"S" = (/obj/effect/floor_decal/corner/brown/diagonal,/obj/effect/floor_decal/spline/plain/corner{dir = 8},/turf/simulated/floor/tiled/brown,/area/template_noop)
"T" = (/obj/effect/floor_decal/spline/fancy/wood/corner{dir = 8},/obj/effect/floor_decal/spline/fancy/wood/corner,/turf/simulated/floor/trim/darkwood,/area/template_noop)
"U" = (/obj/effect/floor_decal/corner/brown/diagonal,/obj/effect/floor_decal/spline/plain{dir = 10},/obj/structure/railing/darkwood,/turf/simulated/floor/tiled/brown,/area/template_noop)
"Y" = (/obj/structure/bed/couch/left/sofa{dir = 1},/obj/structure/railing/darkwood,/turf/simulated/floor/trim/carpet/oldred,/area/template_noop)

(1,1,1) = {"
aaaaaaaaaa
PSaaaaaavP
pUFFFFFFLp
yfzzzzzzhy
yjgTggqgQy
yYHtYHeYHy
yYHtYHeYHy
yYHmYHmYHy
yyyyyyyyyy
Kyyyyyyyyy
"}
