"a" = (/obj/effect/floor_decal/corner/black/mono,/turf/simulated/floor/tiled/dark/mono,/area/template_noop)
"e" = (/obj/effect/floor_decal/spline/fancy{dir = 1},/turf/simulated/floor/trim/lino,/area/template_noop)
"f" = (/obj/effect/floor_decal/spline/fancy/corner,/turf/simulated/floor/trim/lino,/area/template_noop)
"j" = (/obj/item/reagent_containers/food/checker/king/red{randpixel = 0},/obj/effect/floor_decal/corner/black/mono,/turf/simulated/floor/tiled/dark/mono,/area/template_noop)
"l" = (/obj/item/reagent_containers/food/checker/pawn{randpixel = 0},/obj/effect/floor_decal/corner/black/mono,/turf/simulated/floor/tiled/dark/mono,/area/template_noop)
"n" = (/obj/item/reagent_containers/food/checker/pawn/red{randpixel = 0},/obj/effect/floor_decal/corner/red/mono,/turf/simulated/floor/tiled/mono,/area/template_noop)
"o" = (/obj/effect/floor_decal/corner/red/mono,/turf/simulated/floor/tiled/mono,/area/template_noop)
"q" = (/obj/item/reagent_containers/food/checker/queen/red{randpixel = 0},/obj/effect/floor_decal/corner/red/mono,/turf/simulated/floor/tiled/mono,/area/template_noop)
"t" = (/obj/item/reagent_containers/food/checker/bishop/red{randpixel = 0},/obj/effect/floor_decal/corner/red/mono,/turf/simulated/floor/tiled/mono,/area/template_noop)
"v" = (/obj/item/reagent_containers/food/checker/rook{randpixel = 0},/obj/effect/floor_decal/corner/red/mono,/turf/simulated/floor/tiled/mono,/area/template_noop)
"y" = (/obj/item/reagent_containers/food/checker/knight/red{randpixel = 0},/obj/effect/floor_decal/corner/red/mono,/turf/simulated/floor/tiled/mono,/area/template_noop)
"B" = (/obj/item/reagent_containers/food/checker/knight{randpixel = 0},/obj/effect/floor_decal/corner/black/mono,/turf/simulated/floor/tiled/dark/mono,/area/template_noop)
"C" = (/obj/effect/floor_decal/spline/fancy/corner{dir = 8},/turf/simulated/floor/trim/lino,/area/template_noop)
"D" = (/obj/item/reagent_containers/food/checker/pawn{randpixel = 0},/obj/effect/floor_decal/corner/red/mono,/turf/simulated/floor/tiled/mono,/area/template_noop)
"E" = (/obj/item/reagent_containers/food/checker/bishop{randpixel = 0},/obj/effect/floor_decal/corner/red/mono,/turf/simulated/floor/tiled/mono,/area/template_noop)
"G" = (/obj/item/reagent_containers/food/checker/rook/red{randpixel = 0},/obj/effect/floor_decal/corner/black/mono,/turf/simulated/floor/tiled/dark/mono,/area/template_noop)
"H" = (/obj/item/reagent_containers/food/checker/knight/red{randpixel = 0},/obj/effect/floor_decal/corner/black/mono,/turf/simulated/floor/tiled/dark/mono,/area/template_noop)
"I" = (/obj/effect/floor_decal/spline/fancy,/turf/simulated/floor/trim/lino,/area/template_noop)
"J" = (/obj/item/reagent_containers/food/checker/king{randpixel = 0},/obj/effect/floor_decal/corner/red/mono,/turf/simulated/floor/tiled/mono,/area/template_noop)
"K" = (/obj/effect/floor_decal/spline/fancy{dir = 8},/turf/simulated/floor/trim/lino,/area/template_noop)
"M" = (/obj/effect/floor_decal/spline/fancy{dir = 4},/turf/simulated/floor/trim/lino,/area/template_noop)
"N" = (/obj/item/reagent_containers/food/checker/knight{randpixel = 0},/obj/effect/floor_decal/corner/red/mono,/turf/simulated/floor/tiled/mono,/area/template_noop)
"P" = (/obj/effect/floor_decal/spline/fancy/corner{dir = 1},/turf/simulated/floor/trim/lino,/area/template_noop)
"Q" = (/obj/effect/floor_decal/spline/fancy/corner{dir = 4},/turf/simulated/floor/trim/lino,/area/template_noop)
"S" = (/obj/item/reagent_containers/food/checker/pawn/red{randpixel = 0},/obj/effect/floor_decal/corner/black/mono,/turf/simulated/floor/tiled/dark/mono,/area/template_noop)
"U" = (/obj/item/reagent_containers/food/checker/queen{randpixel = 0},/obj/effect/floor_decal/corner/black/mono,/turf/simulated/floor/tiled/dark/mono,/area/template_noop)
"V" = (/obj/item/reagent_containers/food/checker/rook{randpixel = 0},/obj/effect/floor_decal/corner/black/mono,/turf/simulated/floor/tiled/dark/mono,/area/template_noop)
"W" = (/obj/item/reagent_containers/food/checker/rook/red{randpixel = 0},/obj/effect/floor_decal/corner/red/mono,/turf/simulated/floor/tiled/mono,/area/template_noop)
"Y" = (/obj/item/reagent_containers/food/checker/bishop/red{randpixel = 0},/obj/effect/floor_decal/corner/black/mono,/turf/simulated/floor/tiled/dark/mono,/area/template_noop)
"Z" = (/obj/item/reagent_containers/food/checker/bishop{randpixel = 0},/obj/effect/floor_decal/corner/black/mono,/turf/simulated/floor/tiled/dark/mono,/area/template_noop)

(1,1,1) = {"
fIIIIIIIIC
MvBEUJZNVK
MlDlDlDlDK
MoaoaoaoaK
MaoaoaoaoK
MoaoaoaoaK
MaoaoaoaoK
MnSnSnSnSK
MGyYqjtHWK
PeeeeeeeeQ
"}
