"aJ" = (/obj/effect/floor_decal/sandfloordec,/obj/effect/floor_decal/oldflood,/obj/structure/disposalpipe/segment{dir = 8; icon_state = "pipe-c"},/obj/machinery/atmospherics/pipe/simple/hidden/scrubbers{dir = 9},/turf/simulated/floor/tiled/rough,/area/hydroponics/biodome)
"by" = (/obj/machinery/light{dir = 8},/turf/simulated/floor/tiled/mono,/area/hydroponics/biodome)
"cD" = (/obj/effect/floor_decal/sandfloordec,/obj/effect/floor_decal/oldflood,/obj/structure/disposalpipe/segment{dir = 4; icon_state = "pipe-c"},/obj/machinery/atmospherics/pipe/simple/hidden/scrubbers{dir = 6},/obj/machinery/navbeacon/frontier/DOME_NE,/turf/simulated/floor/tiled/rough,/area/hydroponics/biodome)
"cL" = (/obj/structure/flora/ausbushes/grassybush,/turf/simulated/floor/natural/jungle/dirt,/area/hydroponics/biodome)
"dO" = (/obj/effect/floor_decal/corner/green/three_quarters{dir = 1},/obj/structure/disposalpipe/segment{dir = 2; icon_state = "pipe-c"},/turf/simulated/floor/tiled/rough,/area/hallway/primary/frontier/ring_south)
"eJ" = (/obj/effect/floor_decal/stairs{dir = 4},/turf/simulated/floor/natural/jungle/dirt,/area/hydroponics/biodome)
"fv" = (/obj/machinery/door/firedoor/border_only,/obj/machinery/door/blast/shutters{density = 0; dir = 2; icon_state = "shutter0"; id = "bridge_window"; name = "Bridge Window Shutters"; opacity = 0},/obj/structure/cable/green{d2 = 8; icon_state = "0-8"},/obj/structure/cable/green,/obj/structure/window_frame/relectric/rglass,/turf/simulated/floor/tiled/dark/rough,/area/bridge)
"fM" = (/obj/structure/flora/ausbushes/fullgrass,/turf/simulated/floor/natural/jungle/dirt,/area/hydroponics/biodome)
"gi" = (/obj/effect/floor_decal/floordetail/edgedrain{dir = 1},/obj/structure/railing/steel{dir = 1},/turf/simulated/floor/natural/jungle/dirt,/area/hydroponics/biodome)
"hH" = (/turf/simulated/floor/tiled/dark/mono,/area/hydroponics/biodome)
"io" = (/obj/machinery/door/firedoor/border_only,/obj/machinery/door/airlock/glass{name = "Central Biodome"; req_access = list()},/obj/machinery/atmospherics/pipe/simple/hidden/supply{dir = 4},/obj/structure/disposalpipe/segment{dir = 4},/obj/structure/cable{d1 = 4; d2 = 8; icon_state = "4-8"},/obj/effect/floor_decal/sandfloordec,/turf/simulated/floor/tiled/rough,/area/hydroponics/biodome)
"iV" = (/obj/structure/flora/ausbushes/sparsegrass,/turf/simulated/floor/natural/jungle/dirt,/area/hydroponics/biodome)
"jQ" = (/obj/machinery/atmospherics/pipe/simple/hidden/supply{dir = 6},/obj/machinery/navbeacon/frontier/DOME_SE,/turf/simulated/floor/tiled/rough,/area/hallway/primary/frontier/ring_south)
"kU" = (/obj/structure/disposalpipe/segment{dir = 4},/obj/structure/cable{d1 = 4; d2 = 8; icon_state = "4-8"},/obj/effect/floor_decal/sandfloordec,/obj/effect/floor_decal/oldflood,/obj/machinery/atmospherics/pipe/manifold/hidden/supply{dir = 1},/turf/simulated/floor/tiled/rough,/area/hydroponics/biodome)
"lC" = (/obj/effect/floor_decal/corner/green,/turf/simulated/floor/tiled/rough,/area/hallway/primary/frontier/ring_north)
"lH" = (/obj/effect/floor_decal/sandfloordec,/obj/effect/floor_decal/oldflood,/obj/structure/disposalpipe/segment{dir = 2; icon_state = "pipe-c"},/obj/machinery/atmospherics/pipe/simple/hidden/supply{dir = 10},/obj/structure/cable{icon_state = "2-8"},/turf/simulated/floor/tiled/rough,/area/hydroponics/biodome)
"md" = (/obj/structure/bed/pew/pewchapel/left{dir = 1; icon_state = "chair_pewchapel_left_over"; name = "bench"},/turf/simulated/floor/natural/jungle/dirt,/area/hydroponics/biodome)
"mT" = (/obj/structure/disposalpipe/segment{dir = 2; icon_state = "pipe-c"},/obj/machinery/navbeacon/frontier/DOME_SW,/turf/simulated/floor/tiled/rough,/area/hallway/primary/frontier/ring_south)
"oq" = (/obj/machinery/light{dir = 4},/turf/simulated/floor/tiled/dark/mono,/area/hydroponics/biodome)
"pb" = (/obj/effect/floor_decal/corner/green{dir = 1},/turf/simulated/floor/tiled/rough,/area/hallway/primary/frontier/ring_south)
"pg" = (/obj/structure/flora/ausbushes/fullgrass,/obj/machinery/light{dir = 4; icon_state = "tube1"},/turf/simulated/floor/natural/jungle/dirt,/area/hydroponics/biodome)
"ph" = (/turf/simulated/floor/natural/jungle/dirt,/area/hydroponics/biodome)
"px" = (/obj/machinery/light{dir = 4; icon_state = "tube1"},/turf/simulated/floor/tiled/mono,/area/hydroponics/biodome)
"qu" = (/obj/machinery/door/firedoor/border_only,/obj/machinery/door/airlock/glass{name = "Central Biodome"; req_access = list()},/obj/effect/floor_decal/sandfloordec,/obj/effect/floor_decal/oldflood,/turf/simulated/floor/tiled/rough,/area/hydroponics/biodome)
"qw" = (/obj/structure/barrel,/turf/simulated/floor/natural/jungle/dirt,/area/hydroponics/biodome)
"rq" = (/obj/effect/floor_decal/corner/green{dir = 5},/obj/structure/disposalpipe/segment{dir = 2; icon_state = "pipe-c"},/obj/structure/cable/yellow{d1 = 2; d2 = 8; icon_state = "2-8"},/turf/simulated/floor/tiled/rough,/area/hallway/primary/frontier/ring_south)
"rx" = (/obj/effect/firefly,/turf/simulated/floor/natural/jungle/dirt,/area/hydroponics/biodome)
"sb" = (/obj/effect/floor_decal/stairs,/turf/simulated/floor/natural/jungle/dirt,/area/hydroponics/biodome)
"sd" = (/obj/effect/floor_decal/sandfloordec,/obj/effect/floor_decal/oldflood,/obj/structure/disposalpipe/segment{dir = 4},/obj/machinery/atmospherics/pipe/simple/hidden/scrubbers{dir = 4},/turf/simulated/floor/tiled/rough,/area/hydroponics/biodome)
"se" = (/obj/structure/flora/ausbushes/glowshroom,/turf/simulated/floor/natural/jungle/dirt,/area/hydroponics/biodome)
"sk" = (/obj/machinery/door/firedoor/border_only,/obj/machinery/door/blast/shutters{density = 0; dir = 2; icon_state = "shutter0"; id = "bridge_window"; name = "Bridge Window Shutters"; opacity = 0},/obj/structure/cable/green{d2 = 8; icon_state = "0-8"},/obj/structure/cable/green{d2 = 4; icon_state = "0-4"},/obj/structure/window_frame/relectric/rglass,/turf/simulated/floor/tiled/dark/rough,/area/bridge)
"sp" = (/obj/effect/floor_decal/corner/green{dir = 1},/obj/machinery/atmospherics/pipe/simple/hidden/scrubbers{dir = 4},/turf/simulated/floor/tiled/rough,/area/hallway/primary/frontier/ring_south)
"sX" = (/obj/machinery/atmospherics/pipe/simple/hidden/scrubbers{dir = 4},/obj/structure/disposalpipe/segment{dir = 8},/obj/effect/floor_decal/sandfloordec,/obj/effect/floor_decal/oldflood,/turf/simulated/floor/tiled/rough,/area/hydroponics/biodome)
"tC" = (/obj/effect/floor_decal/corner/green/three_quarters{dir = 8},/turf/simulated/floor/tiled/rough,/area/hallway/primary/frontier/ring_south)
"uK" = (/obj/structure/flora/ausbushes/fullgrass,/obj/effect/firefly,/turf/simulated/floor/natural/jungle/dirt,/area/hydroponics/biodome)
"uX" = (/obj/effect/floor_decal/stairs{dir = 8},/turf/simulated/floor/natural/jungle/dirt,/area/hydroponics/biodome)
"vo" = (/obj/effect/floor_decal/corner/green{dir = 6},/obj/machinery/atmospherics/unary/vent_pump/on{dir = 8},/obj/structure/disposalpipe/segment,/obj/structure/cable/yellow{d1 = 2; d2 = 8; icon_state = "2-8"},/turf/simulated/floor/tiled/rough,/area/hallway/primary/frontier/ring_south)
"vC" = (/obj/effect/floor_decal/sandfloordec,/obj/effect/floor_decal/oldflood,/obj/structure/disposalpipe/segment{dir = 4; icon_state = "pipe-c"},/obj/machinery/atmospherics/pipe/simple/hidden/supply{dir = 6},/obj/structure/cable{d1 = 2; d2 = 4; icon_state = "2-4"},/turf/simulated/floor/tiled/rough,/area/hydroponics/biodome)
"vP" = (/obj/effect/floor_decal/floordetail/edgedrain{dir = 9},/obj/structure/railing/steel{dir = 8; icon_state = "newrailing0"},/turf/simulated/floor/natural/jungle/dirt,/area/hydroponics/biodome)
"wl" = (/obj/structure/flora/ausbushes/grassybush,/obj/structure/flora/ausbushes/sparsegrass,/turf/simulated/floor/natural/jungle/dirt,/area/hydroponics/biodome)
"wp" = (/obj/effect/floor_decal/sandfloordec,/obj/effect/floor_decal/oldflood,/obj/structure/disposalpipe/segment{dir = 4; icon_state = "pipe-c"},/obj/machinery/atmospherics/pipe/simple/hidden/scrubbers{dir = 6},/turf/simulated/floor/tiled/rough,/area/hydroponics/biodome)
"xA" = (/obj/machinery/firealarm{dir = 8; pixel_x = -24; pixel_y = -2},/obj/effect/floor_decal/sandfloordec,/obj/effect/floor_decal/oldflood,/obj/machinery/atmospherics/unary/vent_pump/on{dir = 1},/turf/simulated/floor/tiled/rough,/area/hydroponics/biodome)
"yf" = (/obj/effect/floor_decal/corner/green/three_quarters{dir = 1},/obj/structure/disposalpipe/segment{dir = 2; icon_state = "pipe-c"},/obj/structure/cable/yellow{d1 = 2; d2 = 8; icon_state = "2-8"},/turf/simulated/floor/tiled/rough,/area/hallway/primary/frontier/ring_south)
"yz" = (/obj/machinery/alarm{dir = 8; pixel_x = 24},/obj/structure/disposalpipe/trunk{dir = 1},/obj/machinery/disposal,/obj/effect/floor_decal/sandfloordec,/obj/effect/floor_decal/oldflood,/turf/simulated/floor/tiled/rough,/area/hydroponics/biodome)
"zw" = (/obj/effect/floor_decal/corner/green{dir = 5},/turf/simulated/floor/tiled/rough,/area/hallway/primary/frontier/ring_south)
"zx" = (/obj/effect/floor_decal/sandfloordec,/obj/effect/floor_decal/oldflood,/obj/structure/disposalpipe/segment{dir = 1; icon_state = "pipe-c"},/obj/machinery/atmospherics/pipe/simple/hidden/supply{dir = 5},/obj/machinery/navbeacon/frontier/DOME_NW,/obj/structure/cable{d1 = 1; d2 = 4; icon_state = "1-4"},/turf/simulated/floor/tiled/rough,/area/hydroponics/biodome)
"zF" = (/obj/effect/floor_decal/corner/green/three_quarters,/turf/simulated/floor/tiled/rough,/area/hallway/primary/frontier/ring_north)
"Ai" = (/obj/machinery/door/firedoor/border_only,/obj/machinery/door/airlock/glass{name = "Central Biodome"; req_access = list()},/obj/machinery/atmospherics/pipe/simple/hidden/scrubbers{dir = 4},/obj/structure/disposalpipe/segment{dir = 8},/obj/effect/floor_decal/sandfloordec,/turf/simulated/floor/tiled/rough,/area/hydroponics/biodome)
"BG" = (/obj/machinery/light{dir = 8},/turf/simulated/floor/tiled/dark/mono,/area/hydroponics/biodome)
"Cx" = (/obj/effect/floor_decal/corner/green{dir = 6},/turf/simulated/floor/tiled/rough,/area/hallway/primary/frontier/ring_north)
"CZ" = (/obj/structure/flora/log,/turf/simulated/floor/natural/jungle/dirt,/area/hydroponics/biodome)
"Db" = (/obj/effect/floor_decal/corner/green{dir = 4},/obj/structure/disposalpipe/segment{dir = 1; icon_state = "pipe-c"},/obj/structure/cable/yellow{d1 = 1; d2 = 4; icon_state = "1-4"},/turf/simulated/floor/tiled/rough,/area/hallway/primary/frontier/ring_south)
"DJ" = (/obj/effect/floor_decal/sandfloordec,/obj/effect/floor_decal/oldflood,/obj/machinery/atmospherics/unary/vent_scrubber/on,/turf/simulated/floor/tiled/rough,/area/hydroponics/biodome)
"Em" = (/obj/effect/floor_decal/floordetail/edgedrain{dir = 1},/obj/structure/railing/steel{dir = 1},/obj/machinery/camera/network/civilian_east{c_tag = "Central Garden - East"; dir = 8},/turf/simulated/floor/natural/jungle/dirt,/area/hydroponics/biodome)
"ET" = (/obj/structure/gravemarker/random,/turf/simulated/floor/natural/jungle/dirt,/area/hydroponics/biodome)
"EY" = (/obj/machinery/power/apc{dir = 4; name = "east bump"; pixel_x = 24},/obj/structure/cable/white{icon_state = "0-2"},/obj/effect/floor_decal/sandfloordec,/obj/effect/floor_decal/oldflood,/turf/simulated/floor/tiled/rough,/area/hydroponics/biodome)
"Fb" = (/obj/effect/floor_decal/sandfloordec,/obj/effect/floor_decal/oldflood,/obj/structure/disposalpipe/segment{dir = 1; icon_state = "pipe-c"},/obj/machinery/atmospherics/pipe/simple/hidden/supply{dir = 5},/obj/structure/cable{d1 = 1; d2 = 4; icon_state = "1-4"},/turf/simulated/floor/tiled/rough,/area/hydroponics/biodome)
"IX" = (/obj/effect/floor_decal/corner/green/three_quarters{dir = 4},/turf/simulated/floor/tiled/rough,/area/hallway/primary/frontier/ring_north)
"JJ" = (/obj/effect/floor_decal/floordetail/edgedrain{dir = 5},/obj/structure/railing/steel{dir = 4; icon_state = "newrailing0"},/turf/simulated/floor/natural/jungle/dirt,/area/hydroponics/biodome)
"KI" = (/obj/structure/window_frame/rglass,/obj/machinery/door/firedoor/border_only,/turf/simulated/floor/plating,/area/hydroponics/biodome)
"KJ" = (/obj/effect/floor_decal/sandfloordec,/obj/effect/floor_decal/oldflood,/turf/simulated/floor/tiled/rough,/area/hydroponics/biodome)
"Mo" = (/obj/machinery/door/firedoor/border_only,/obj/machinery/door/airlock/glass{name = "Central Biodome"; req_access = list()},/obj/machinery/atmospherics/pipe/simple/hidden/scrubbers{dir = 4},/obj/structure/cable/white{icon_state = "4-8"},/obj/structure/disposalpipe/segment{dir = 8},/obj/effect/floor_decal/sandfloordec,/turf/simulated/floor/tiled/rough,/area/hydroponics/biodome)
"MI" = (/obj/effect/floor_decal/corner/green/three_quarters,/obj/structure/disposalpipe/segment{dir = 1; icon_state = "pipe-c"},/turf/simulated/floor/tiled/rough,/area/hallway/primary/frontier/ring_north)
"Nh" = (/obj/effect/floor_decal/sandfloordec,/obj/effect/floor_decal/oldflood,/obj/structure/disposalpipe/segment{dir = 4},/obj/machinery/atmospherics/pipe/simple/hidden/supply{dir = 4},/obj/structure/cable{d1 = 4; d2 = 8; icon_state = "4-8"},/turf/simulated/floor/tiled/rough,/area/hydroponics/biodome)
"Oa" = (/obj/effect/floor_decal/corner/green/three_quarters{dir = 1},/turf/simulated/floor/tiled/rough,/area/hallway/primary/frontier/ring_south)
"Oo" = (/turf/simulated/wall/silver,/area/hydroponics/biodome)
"PG" = (/obj/effect/floor_decal/corner/green{dir = 8},/obj/structure/disposalpipe/segment,/turf/simulated/floor/tiled/rough,/area/hallway/primary/frontier/ring_north)
"Qo" = (/obj/effect/floor_decal/sandfloordec,/obj/effect/floor_decal/oldflood,/obj/structure/disposalpipe/segment,/obj/machinery/atmospherics/pipe/simple/hidden/scrubbers,/turf/simulated/floor/tiled/rough,/area/hydroponics/biodome)
"QE" = (/obj/effect/floor_decal/sandfloordec,/obj/effect/floor_decal/oldflood,/obj/structure/disposalpipe/segment{dir = 1; icon_state = "pipe-c"},/obj/machinery/atmospherics/pipe/simple/hidden/scrubbers{dir = 5},/turf/simulated/floor/tiled/rough,/area/hydroponics/biodome)
"Rf" = (/obj/effect/floor_decal/sandfloordec,/obj/effect/floor_decal/oldflood,/obj/structure/disposalpipe/segment{dir = 8; icon_state = "pipe-c"},/obj/machinery/atmospherics/pipe/simple/hidden/supply{dir = 9; pixel_y = 0},/obj/structure/cable{d1 = 1; d2 = 8; icon_state = "1-8"},/obj/machinery/navbeacon/frontier/DOME_NE,/turf/simulated/floor/tiled/rough,/area/hydroponics/biodome)
"RB" = (/turf/simulated/floor/tiled/mono,/area/hydroponics/biodome)
"SK" = (/obj/effect/floor_decal/sandfloordec,/obj/effect/floor_decal/oldflood,/obj/structure/disposalpipe/segment{dir = 2; icon_state = "pipe-c"},/obj/machinery/atmospherics/pipe/simple/hidden/scrubbers{dir = 10},/turf/simulated/floor/tiled/rough,/area/hydroponics/biodome)
"SR" = (/obj/effect/floor_decal/corner/green/three_quarters{dir = 8},/obj/machinery/atmospherics/unary/vent_scrubber/on{dir = 4},/turf/simulated/floor/tiled/rough,/area/hallway/primary/frontier/ring_south)
"Tg" = (/obj/structure/bed/pew/pewchapel/right{dir = 1; icon_state = "chair_pewchapel_right_over"; name = "bench"},/turf/simulated/floor/natural/jungle/dirt,/area/hydroponics/biodome)
"TD" = (/obj/effect/floor_decal/floordetail/edgedrain{dir = 1},/obj/structure/railing/steel{dir = 1},/obj/machinery/camera/network/civilian_east{c_tag = "Central Garden - West"; dir = 4},/turf/simulated/floor/natural/jungle/dirt,/area/hydroponics/biodome)
"TN" = (/obj/structure/disposalpipe/segment{dir = 8},/obj/effect/floor_decal/sandfloordec,/obj/effect/floor_decal/oldflood,/obj/machinery/atmospherics/pipe/manifold/hidden/scrubbers,/turf/simulated/floor/tiled/rough,/area/hydroponics/biodome)
"UO" = (/obj/effect/floor_decal/corner/green{dir = 9},/obj/structure/disposalpipe/segment,/turf/simulated/floor/tiled/rough,/area/hallway/primary/frontier/ring_north)
"UX" = (/obj/machinery/door/firedoor/border_only,/obj/machinery/door/blast/shutters{density = 0; dir = 2; icon_state = "shutter0"; id = "bridge_window"; name = "Bridge Window Shutters"; opacity = 0},/obj/structure/cable/green{d2 = 4; icon_state = "0-4"},/obj/structure/cable/green,/obj/structure/window_frame/relectric/rglass,/turf/simulated/floor/tiled/dark/rough,/area/bridge)
"VT" = (/obj/effect/floor_decal/sandfloordec,/obj/effect/floor_decal/oldflood,/obj/structure/disposalpipe/segment{dir = 8},/obj/machinery/atmospherics/pipe/simple/hidden/scrubbers{dir = 4},/turf/simulated/floor/tiled/rough,/area/hydroponics/biodome)
"WJ" = (/obj/machinery/atmospherics/pipe/simple/hidden/supply{dir = 4},/obj/structure/cable{d1 = 4; d2 = 8; icon_state = "4-8"},/obj/structure/disposalpipe/junction{dir = 8; icon_state = "pipe-j2"},/obj/effect/floor_decal/sandfloordec,/obj/effect/floor_decal/oldflood,/turf/simulated/floor/tiled/rough,/area/hydroponics/biodome)
"WS" = (/obj/machinery/light{dir = 8; icon_state = "tube1"},/turf/simulated/floor/natural/jungle/dirt,/area/hydroponics/biodome)
"Xy" = (/obj/effect/floor_decal/corner/green{dir = 9},/turf/simulated/floor/tiled/rough,/area/hallway/primary/frontier/ring_south)
"XD" = (/obj/effect/floor_decal/sandfloordec,/obj/effect/floor_decal/oldflood,/obj/structure/disposalpipe/segment{dir = 2; icon_state = "pipe-c"},/obj/machinery/atmospherics/pipe/simple/hidden/scrubbers{dir = 10},/obj/machinery/navbeacon/frontier/DOME_NW,/turf/simulated/floor/tiled/rough,/area/hydroponics/biodome)
"XJ" = (/turf/simulated/wall,/area/hydroponics/biodome)
"XM" = (/obj/effect/floor_decal/sandfloordec,/obj/effect/floor_decal/oldflood,/obj/structure/disposalpipe/segment{dir = 8; icon_state = "pipe-c"},/obj/machinery/atmospherics/pipe/simple/hidden/supply{dir = 9; pixel_y = 0},/obj/structure/cable{d1 = 1; d2 = 8; icon_state = "1-8"},/turf/simulated/floor/tiled/rough,/area/hydroponics/biodome)
"Zo" = (/obj/machinery/atmospherics/pipe/simple/hidden/scrubbers{dir = 4},/obj/structure/cable/white{icon_state = "1-4"},/obj/effect/floor_decal/sandfloordec,/obj/structure/disposalpipe/segment{dir = 8},/obj/effect/floor_decal/oldflood,/turf/simulated/floor/tiled/rough,/area/hydroponics/biodome)

(1,1,1) = {"
lCIXKIKIKIBGUXskskskfvoqKIKIKIzFPG
CxKIKIRBuXhHhHhHhHhHhHhHeJRBKIKIUO
IXKIRBRBuXhHhHhHhHhHhHhHeJRBRBKIMI
KIKIbyRBuXhHhHhHhHhHhHhHeJRBpxKIKI
KIJJsbsbOoTDgigigigigiEmOosbsbvPKI
XJDJKJKJseCZphphphphphCZphKJKJEYXJ
AiTNsXXDrxphphphqwsephrxphcDVTZoMo
KIwlcLQofMCZphphphphphCZcLQowlcLKI
iokUlHQESKsephCZphCZphphwpaJvCWJio
XJxAFblHQESKphphphsephwpaJvCXMyzXJ
KIseETFblHQESKfMuKphwpaJvCXMphphKI
KIKIWSsezxlHQEsdsdsdaJvCRfphpgKIKI
dOKIfMrxphFbNhNhNhNhNhXMphsephKItC
voKIKIETphsemdTgKJmdTgphiVphKIKIXy
DbyfKIKIKIfMcLphKJphfMrxKIKIKISRsp
mTDbrqOaKIKIKIKIquKIKIKIKItCzwpbjQ
"}
