"aJ" = (/obj/effect/floor_decal/sandfloordec,/obj/effect/floor_decal/oldflood,/obj/structure/disposalpipe/segment{dir = 8; icon_state = "pipe-c"},/obj/machinery/atmospherics/pipe/simple/hidden/scrubbers{dir = 9},/turf/floor/tiled/rough,/area/hydroponics/biodome)
"by" = (/obj/machinery/light{dir = 8},/turf/floor/tiled/mono,/area/hydroponics/biodome)
"cD" = (/obj/effect/floor_decal/sandfloordec,/obj/effect/floor_decal/oldflood,/obj/structure/disposalpipe/segment{dir = 4; icon_state = "pipe-c"},/obj/machinery/atmospherics/pipe/simple/hidden/scrubbers{dir = 6},/obj/machinery/navbeacon/frontier/DOME_NE,/turf/floor/tiled/rough,/area/hydroponics/biodome)
"cL" = (/obj/structure/flora/ausbushes/grassybush,/turf/floor/natural/jungle/dirt,/area/hydroponics/biodome)
"eJ" = (/obj/effect/floor_decal/stairs{dir = 4},/turf/floor/natural/jungle/dirt,/area/hydroponics/biodome)
"fM" = (/obj/structure/flora/ausbushes/fullgrass,/turf/floor/natural/jungle/dirt,/area/hydroponics/biodome)
"gi" = (/obj/effect/floor_decal/floordetail/edgedrain{dir = 1},/obj/structure/railing/steel{dir = 1},/turf/floor/natural/jungle/dirt,/area/hydroponics/biodome)
"hH" = (/turf/floor/tiled/dark/mono,/area/hydroponics/biodome)
"io" = (/obj/machinery/door/firedoor/border_only,/obj/machinery/door/airlock/glass{name = "Central Biodome"; req_access = list()},/obj/machinery/atmospherics/pipe/simple/hidden/supply{dir = 4},/obj/structure/disposalpipe/segment{dir = 4},/obj/structure/cable{d1 = 4; d2 = 8; icon_state = "4-8"},/obj/effect/floor_decal/sandfloordec,/turf/floor/tiled/rough,/area/hydroponics/biodome)
"iV" = (/obj/structure/flora/ausbushes/sparsegrass,/turf/floor/natural/jungle/dirt,/area/hydroponics/biodome)
"kU" = (/obj/structure/disposalpipe/segment{dir = 4},/obj/structure/cable{d1 = 4; d2 = 8; icon_state = "4-8"},/obj/effect/floor_decal/sandfloordec,/obj/effect/floor_decal/oldflood,/obj/machinery/atmospherics/pipe/manifold/hidden/supply{dir = 1},/turf/floor/tiled/rough,/area/hydroponics/biodome)
"lH" = (/obj/effect/floor_decal/sandfloordec,/obj/effect/floor_decal/oldflood,/obj/structure/disposalpipe/segment{dir = 2; icon_state = "pipe-c"},/obj/machinery/atmospherics/pipe/simple/hidden/supply{dir = 10},/obj/structure/cable{icon_state = "2-8"},/turf/floor/tiled/rough,/area/hydroponics/biodome)
"md" = (/obj/structure/bed/pew/pewchapel/left{dir = 1; icon_state = "chair_pewchapel_left_over"; name = "bench"},/turf/floor/natural/jungle/dirt,/area/hydroponics/biodome)
"oq" = (/obj/machinery/light{dir = 4},/turf/floor/tiled/dark/mono,/area/hydroponics/biodome)
"pg" = (/obj/structure/flora/ausbushes/fullgrass,/obj/machinery/light{dir = 4; icon_state = "tube1"},/turf/floor/natural/jungle/dirt,/area/hydroponics/biodome)
"ph" = (/turf/floor/natural/jungle/dirt,/area/hydroponics/biodome)
"px" = (/obj/machinery/light{dir = 4; icon_state = "tube1"},/turf/floor/tiled/mono,/area/hydroponics/biodome)
"qu" = (/obj/machinery/door/firedoor/border_only,/obj/machinery/door/airlock/glass{name = "Central Biodome"; req_access = list()},/obj/effect/floor_decal/sandfloordec,/obj/effect/floor_decal/oldflood,/turf/floor/tiled/rough,/area/hydroponics/biodome)
"qw" = (/obj/structure/barrel,/turf/floor/natural/jungle/dirt,/area/hydroponics/biodome)
"rx" = (/obj/effect/firefly,/turf/floor/natural/jungle/dirt,/area/hydroponics/biodome)
"sb" = (/obj/effect/floor_decal/stairs,/turf/floor/natural/jungle/dirt,/area/hydroponics/biodome)
"sd" = (/obj/effect/floor_decal/sandfloordec,/obj/effect/floor_decal/oldflood,/obj/structure/disposalpipe/segment{dir = 4},/obj/machinery/atmospherics/pipe/simple/hidden/scrubbers{dir = 4},/turf/floor/tiled/rough,/area/hydroponics/biodome)
"se" = (/obj/structure/flora/ausbushes/glowshroom,/turf/floor/natural/jungle/dirt,/area/hydroponics/biodome)
"sk" = (/turf/space,/area/space)
"sX" = (/obj/machinery/atmospherics/pipe/simple/hidden/scrubbers{dir = 4},/obj/structure/disposalpipe/segment{dir = 8},/obj/effect/floor_decal/sandfloordec,/obj/effect/floor_decal/oldflood,/turf/floor/tiled/rough,/area/hydroponics/biodome)
"uK" = (/obj/structure/flora/ausbushes/fullgrass,/obj/effect/firefly,/turf/floor/natural/jungle/dirt,/area/hydroponics/biodome)
"uX" = (/obj/effect/floor_decal/stairs{dir = 8},/turf/floor/natural/jungle/dirt,/area/hydroponics/biodome)
"vC" = (/obj/effect/floor_decal/sandfloordec,/obj/effect/floor_decal/oldflood,/obj/structure/disposalpipe/segment{dir = 4; icon_state = "pipe-c"},/obj/machinery/atmospherics/pipe/simple/hidden/supply{dir = 6},/obj/structure/cable{d1 = 2; d2 = 4; icon_state = "2-4"},/turf/floor/tiled/rough,/area/hydroponics/biodome)
"vP" = (/obj/effect/floor_decal/floordetail/edgedrain{dir = 9},/obj/structure/railing/steel{dir = 8; icon_state = "newrailing0"},/turf/floor/natural/jungle/dirt,/area/hydroponics/biodome)
"wl" = (/obj/structure/flora/ausbushes/grassybush,/obj/structure/flora/ausbushes/sparsegrass,/turf/floor/natural/jungle/dirt,/area/hydroponics/biodome)
"wp" = (/obj/effect/floor_decal/sandfloordec,/obj/effect/floor_decal/oldflood,/obj/structure/disposalpipe/segment{dir = 4; icon_state = "pipe-c"},/obj/machinery/atmospherics/pipe/simple/hidden/scrubbers{dir = 6},/turf/floor/tiled/rough,/area/hydroponics/biodome)
"xA" = (/obj/machinery/firealarm{dir = 8; pixel_x = -24; pixel_y = -2},/obj/effect/floor_decal/sandfloordec,/obj/effect/floor_decal/oldflood,/obj/machinery/atmospherics/unary/vent_pump/on{dir = 1},/turf/floor/tiled/rough,/area/hydroponics/biodome)
"yz" = (/obj/machinery/alarm{dir = 8; pixel_x = 24},/obj/structure/disposalpipe/trunk{dir = 1},/obj/machinery/disposal,/obj/effect/floor_decal/sandfloordec,/obj/effect/floor_decal/oldflood,/turf/floor/tiled/rough,/area/hydroponics/biodome)
"zx" = (/obj/effect/floor_decal/sandfloordec,/obj/effect/floor_decal/oldflood,/obj/structure/disposalpipe/segment{dir = 1; icon_state = "pipe-c"},/obj/machinery/atmospherics/pipe/simple/hidden/supply{dir = 5},/obj/machinery/navbeacon/frontier/DOME_NW,/obj/structure/cable{d1 = 1; d2 = 4; icon_state = "1-4"},/turf/floor/tiled/rough,/area/hydroponics/biodome)
"Ai" = (/obj/machinery/door/firedoor/border_only,/obj/machinery/door/airlock/glass{name = "Central Biodome"; req_access = list()},/obj/machinery/atmospherics/pipe/simple/hidden/scrubbers{dir = 4},/obj/structure/disposalpipe/segment{dir = 8},/obj/effect/floor_decal/sandfloordec,/turf/floor/tiled/rough,/area/hydroponics/biodome)
"BG" = (/obj/machinery/light{dir = 8},/turf/floor/tiled/dark/mono,/area/hydroponics/biodome)
"CZ" = (/obj/structure/flora/log,/turf/floor/natural/jungle/dirt,/area/hydroponics/biodome)
"DJ" = (/obj/effect/floor_decal/sandfloordec,/obj/effect/floor_decal/oldflood,/obj/machinery/atmospherics/unary/vent_scrubber/on,/turf/floor/tiled/rough,/area/hydroponics/biodome)
"Em" = (/obj/effect/floor_decal/floordetail/edgedrain{dir = 1},/obj/structure/railing/steel{dir = 1},/obj/machinery/camera/network/civilian_east{c_tag = "Central Garden - East"; dir = 8},/turf/floor/natural/jungle/dirt,/area/hydroponics/biodome)
"ET" = (/obj/structure/gravemarker/random,/turf/floor/natural/jungle/dirt,/area/hydroponics/biodome)
"EY" = (/obj/machinery/power/apc{dir = 4; name = "east bump"; pixel_x = 24},/obj/structure/cable/white{icon_state = "0-2"},/obj/effect/floor_decal/sandfloordec,/obj/effect/floor_decal/oldflood,/turf/floor/tiled/rough,/area/hydroponics/biodome)
"Fb" = (/obj/effect/floor_decal/sandfloordec,/obj/effect/floor_decal/oldflood,/obj/structure/disposalpipe/segment{dir = 1; icon_state = "pipe-c"},/obj/machinery/atmospherics/pipe/simple/hidden/supply{dir = 5},/obj/structure/cable{d1 = 1; d2 = 4; icon_state = "1-4"},/turf/floor/tiled/rough,/area/hydroponics/biodome)
"JJ" = (/obj/effect/floor_decal/floordetail/edgedrain{dir = 5},/obj/structure/railing/steel{dir = 4; icon_state = "newrailing0"},/turf/floor/natural/jungle/dirt,/area/hydroponics/biodome)
"KI" = (/obj/structure/window_frame/rglass,/obj/machinery/door/firedoor/border_only,/turf/floor/plating,/area/hydroponics/biodome)
"KJ" = (/obj/effect/floor_decal/sandfloordec,/obj/effect/floor_decal/oldflood,/turf/floor/tiled/rough,/area/hydroponics/biodome)
"Mo" = (/obj/machinery/door/firedoor/border_only,/obj/machinery/door/airlock/glass{name = "Central Biodome"; req_access = list()},/obj/machinery/atmospherics/pipe/simple/hidden/scrubbers{dir = 4},/obj/structure/cable/white{icon_state = "4-8"},/obj/structure/disposalpipe/segment{dir = 8},/obj/effect/floor_decal/sandfloordec,/turf/floor/tiled/rough,/area/hydroponics/biodome)
"Nh" = (/obj/effect/floor_decal/sandfloordec,/obj/effect/floor_decal/oldflood,/obj/structure/disposalpipe/segment{dir = 4},/obj/machinery/atmospherics/pipe/simple/hidden/supply{dir = 4},/obj/structure/cable{d1 = 4; d2 = 8; icon_state = "4-8"},/turf/floor/tiled/rough,/area/hydroponics/biodome)
"Oo" = (/turf/wall/silver,/area/hydroponics/biodome)
"Qo" = (/obj/effect/floor_decal/sandfloordec,/obj/effect/floor_decal/oldflood,/obj/structure/disposalpipe/segment,/obj/machinery/atmospherics/pipe/simple/hidden/scrubbers,/turf/floor/tiled/rough,/area/hydroponics/biodome)
"QE" = (/obj/effect/floor_decal/sandfloordec,/obj/effect/floor_decal/oldflood,/obj/structure/disposalpipe/segment{dir = 1; icon_state = "pipe-c"},/obj/machinery/atmospherics/pipe/simple/hidden/scrubbers{dir = 5},/turf/floor/tiled/rough,/area/hydroponics/biodome)
"Rf" = (/obj/effect/floor_decal/sandfloordec,/obj/effect/floor_decal/oldflood,/obj/structure/disposalpipe/segment{dir = 8; icon_state = "pipe-c"},/obj/machinery/atmospherics/pipe/simple/hidden/supply{dir = 9; pixel_y = 0},/obj/structure/cable{d1 = 1; d2 = 8; icon_state = "1-8"},/obj/machinery/navbeacon/frontier/DOME_NE,/turf/floor/tiled/rough,/area/hydroponics/biodome)
"RB" = (/turf/floor/tiled/mono,/area/hydroponics/biodome)
"SK" = (/obj/effect/floor_decal/sandfloordec,/obj/effect/floor_decal/oldflood,/obj/structure/disposalpipe/segment{dir = 2; icon_state = "pipe-c"},/obj/machinery/atmospherics/pipe/simple/hidden/scrubbers{dir = 10},/turf/floor/tiled/rough,/area/hydroponics/biodome)
"Tg" = (/obj/structure/bed/pew/pewchapel/right{dir = 1; icon_state = "chair_pewchapel_right_over"; name = "bench"},/turf/floor/natural/jungle/dirt,/area/hydroponics/biodome)
"TD" = (/obj/effect/floor_decal/floordetail/edgedrain{dir = 1},/obj/structure/railing/steel{dir = 1},/obj/machinery/camera/network/civilian_east{c_tag = "Central Garden - West"; dir = 4},/turf/floor/natural/jungle/dirt,/area/hydroponics/biodome)
"TN" = (/obj/structure/disposalpipe/segment{dir = 8},/obj/effect/floor_decal/sandfloordec,/obj/effect/floor_decal/oldflood,/obj/machinery/atmospherics/pipe/manifold/hidden/scrubbers,/turf/floor/tiled/rough,/area/hydroponics/biodome)
"VT" = (/obj/effect/floor_decal/sandfloordec,/obj/effect/floor_decal/oldflood,/obj/structure/disposalpipe/segment{dir = 8},/obj/machinery/atmospherics/pipe/simple/hidden/scrubbers{dir = 4},/turf/floor/tiled/rough,/area/hydroponics/biodome)
"WJ" = (/obj/machinery/atmospherics/pipe/simple/hidden/supply{dir = 4},/obj/structure/cable{d1 = 4; d2 = 8; icon_state = "4-8"},/obj/structure/disposalpipe/junction{dir = 8; icon_state = "pipe-j2"},/obj/effect/floor_decal/sandfloordec,/obj/effect/floor_decal/oldflood,/turf/floor/tiled/rough,/area/hydroponics/biodome)
"WS" = (/obj/machinery/light{dir = 8; icon_state = "tube1"},/turf/floor/natural/jungle/dirt,/area/hydroponics/biodome)
"XD" = (/obj/effect/floor_decal/sandfloordec,/obj/effect/floor_decal/oldflood,/obj/structure/disposalpipe/segment{dir = 2; icon_state = "pipe-c"},/obj/machinery/atmospherics/pipe/simple/hidden/scrubbers{dir = 10},/obj/machinery/navbeacon/frontier/DOME_NW,/turf/floor/tiled/rough,/area/hydroponics/biodome)
"XJ" = (/turf/wall,/area/hydroponics/biodome)
"XM" = (/obj/effect/floor_decal/sandfloordec,/obj/effect/floor_decal/oldflood,/obj/structure/disposalpipe/segment{dir = 8; icon_state = "pipe-c"},/obj/machinery/atmospherics/pipe/simple/hidden/supply{dir = 9; pixel_y = 0},/obj/structure/cable{d1 = 1; d2 = 8; icon_state = "1-8"},/turf/floor/tiled/rough,/area/hydroponics/biodome)
"Zo" = (/obj/machinery/atmospherics/pipe/simple/hidden/scrubbers{dir = 4},/obj/structure/cable/white{icon_state = "1-4"},/obj/effect/floor_decal/sandfloordec,/obj/structure/disposalpipe/segment{dir = 8},/obj/effect/floor_decal/oldflood,/turf/floor/tiled/rough,/area/hydroponics/biodome)

(1,1,1) = {"
skskKIKIKIBGskskskskskoqKIKIKIsksk
skKIKIRBuXhHhHhHhHhHhHhHeJRBKIKIsk
skKIRBRBuXhHhHhHhHhHhHhHeJRBRBKIsk
KIKIbyRBuXhHhHhHhHhHhHhHeJRBpxKIKI
KIJJsbsbOoTDgigigigigiEmOosbsbvPKI
XJDJKJKJseCZphphphphphCZphKJKJEYXJ
AiTNsXXDrxphphphqwsephrxphcDVTZoMo
KIwlcLQofMCZphphphphphCZcLQowlcLKI
iokUlHQESKsephCZphCZphphwpaJvCWJio
XJxAFblHQESKphphphsephwpaJvCXMyzXJ
KIseETFblHQESKfMuKphwpaJvCXMphphKI
KIKIWSsezxlHQEsdsdsdaJvCRfphpgKIKI
skKIfMrxphFbNhNhNhNhNhXMphsephKIsk
skKIKIETphsemdTgKJmdTgphiVphKIKIsk
skskKIKIKIfMcLphKJphfMrxKIKIKIsksk
skskskskKIKIKIKIquKIKIKIKIsksksksk
"}
