"aJ" = (/obj/structure/flora/tree/green/small/tree5,/obj/structure/flora/ausbushes/sparsegrass,/obj/effect/floor_decal/spline/fancy/wood/corner{dir = 8},/turf/floor/natural/grass,/area/hydroponics/biodome)
"bh" = (/obj/structure/flora/tree/green/small/tree3,/obj/structure/flora/ausbushes/fullgrass,/turf/floor/natural/grass,/area/hydroponics/biodome)
"bl" = (/obj/structure/flora/ausbushes/fullgrass,/obj/structure/flora/tree/green/small/tree5,/obj/effect/floor_decal/spline/fancy/wood/corner{dir = 8},/turf/floor/natural/grass,/area/hydroponics/biodome)
"by" = (/obj/structure/bed/pew/pewchapel/right{dir = 1; icon_state = "chair_pewchapel_right_over"; name = "bench"},/turf/floor/natural/grass,/area/hydroponics/biodome)
"bX" = (/obj/effect/floor_decal/corner/green{dir = 6},/obj/effect/floor_decal/corner/green{dir = 9},/obj/machinery/atmospherics/pipe/simple/hidden/scrubbers{dir = 4},/obj/structure/disposalpipe/segment{dir = 8},/obj/structure/railing/steel,/turf/floor/tiled/rough,/area/hydroponics/biodome)
"bY" = (/obj/effect/floor_decal/spline/fancy/wood/corner,/obj/structure/flora/ausbushes/fullgrass,/obj/structure/flora/ausbushes/jungleflora/busha,/turf/floor/natural/grass,/area/hydroponics/biodome)
"ch" = (/obj/structure/flora/ausbushes/fernybush,/turf/floor/natural/grass,/area/hydroponics/biodome)
"cv" = (/obj/structure/flora/tree/green/small/tree6,/obj/structure/flora/ausbushes/fullgrass,/turf/floor/natural/grass,/area/hydroponics/biodome)
"cL" = (/obj/effect/floor_decal/corner/green{dir = 6},/obj/effect/floor_decal/corner/green{dir = 9},/obj/machinery/atmospherics/unary/vent_pump/on{layer = 2.4; level = 2},/obj/structure/railing/steel{dir = 4},/turf/floor/tiled/rough,/area/hydroponics/biodome)
"dj" = (/obj/effect/floor_decal/corner/green{dir = 9},/obj/effect/floor_decal/corner/green{dir = 6},/obj/machinery/atmospherics/pipe/simple/hidden/scrubbers{dir = 4},/obj/structure/disposalpipe/segment{dir = 8},/turf/floor/tiled/rough,/area/hydroponics/biodome)
"ed" = (/obj/structure/flora/ausbushes/sparsegrass,/obj/structure/flora/ausbushes/fullgrass,/turf/floor/natural/grass,/area/hydroponics/biodome)
"eJ" = (/obj/structure/bed/pew/pewchapel/left{dir = 1; icon_state = "chair_pewchapel_left_over"; name = "bench"},/turf/floor/natural/grass,/area/hydroponics/biodome)
"eO" = (/obj/structure/flora/ausbushes/grassybush,/turf/floor/natural/grass,/area/hydroponics/biodome)
"fM" = (/obj/structure/flora/ausbushes/lavendergrass,/obj/structure/flora/ausbushes/ppflowers,/turf/floor/natural/grass,/area/hydroponics/biodome)
"fY" = (/obj/effect/floor_decal/corner/green{dir = 5},/obj/effect/floor_decal/corner/green{dir = 10},/obj/effect/floor_decal/plaque,/turf/floor/tiled/rough,/area/hydroponics/biodome)
"gi" = (/obj/structure/flora/ausbushes/fullgrass,/obj/structure/flora/ausbushes/ywflowers,/turf/floor/natural/grass,/area/hydroponics/biodome)
"gW" = (/obj/structure/flora/ausbushes/sparsegrass,/obj/structure/flora/ausbushes/jungleflora/bushb,/turf/floor/natural/grass,/area/hydroponics/biodome)
"hk" = (/obj/effect/floor_decal/corner/green{dir = 6},/obj/effect/floor_decal/corner/green{dir = 9},/obj/machinery/atmospherics/pipe/simple/hidden/supply{dir = 6},/obj/structure/disposalpipe/segment{dir = 4; icon_state = "pipe-c"},/obj/structure/railing/steel{dir = 8},/obj/structure/cable{d1 = 2; d2 = 4; icon_state = "2-4"},/turf/floor/tiled/rough,/area/hydroponics/biodome)
"hH" = (/obj/structure/flora/ausbushes/lavendergrass,/obj/structure/flora/jungleplants/junglebushlarge/bush3,/turf/floor/natural/grass,/area/hydroponics/biodome)
"io" = (/obj/machinery/door/firedoor/border_only,/obj/effect/floor_decal/corner/green{dir = 9},/obj/effect/floor_decal/corner/green{dir = 6},/obj/machinery/door/airlock/glass{name = "Central Biodome"; req_access = list()},/obj/machinery/atmospherics/pipe/simple/hidden/supply{dir = 4},/obj/structure/disposalpipe/segment{dir = 4},/obj/structure/cable{d1 = 4; d2 = 8; icon_state = "4-8"},/turf/floor/tiled/rough,/area/hydroponics/biodome)
"it" = (/obj/structure/flora/ausbushes/genericbush,/obj/structure/flora/ausbushes/lavendergrass,/obj/structure/flora/ausbushes/jungleflora/bushb,/turf/floor/natural/grass,/area/hydroponics/biodome)
"iV" = (/obj/structure/flora/ausbushes/fullgrass,/obj/machinery/light,/turf/floor/natural/grass,/area/hydroponics/biodome)
"iY" = (/obj/structure/flora/ausbushes/fullgrass,/obj/effect/floor_decal/spline/fancy/wood/corner{dir = 4},/turf/floor/natural/grass,/area/hydroponics/biodome)
"jP" = (/obj/structure/flora/ausbushes/lavendergrass,/obj/structure/flora/tree/green/tree8,/turf/floor/natural/grass,/area/hydroponics/biodome)
"kU" = (/obj/effect/floor_decal/corner/green{dir = 6},/obj/effect/floor_decal/corner/green{dir = 9},/obj/machinery/atmospherics/pipe/simple/hidden/supply{dir = 4},/obj/structure/disposalpipe/segment{dir = 4},/obj/structure/cable{d1 = 4; d2 = 8; icon_state = "4-8"},/turf/floor/tiled/rough,/area/hydroponics/biodome)
"lA" = (/obj/structure/flora/ausbushes/lavendergrass,/obj/structure/flora/ausbushes/fernybush,/turf/floor/natural/grass,/area/hydroponics/biodome)
"lH" = (/obj/structure/flora/tree/green/tree9,/turf/floor/natural/grass,/area/hydroponics/biodome)
"md" = (/obj/effect/floor_decal/spline/fancy{dir = 6},/turf/floor/water/fountain,/area/hydroponics/biodome)
"mf" = (/obj/structure/flora/ausbushes/fernybush,/obj/structure/flora/ausbushes/fullgrass,/turf/floor/natural/grass,/area/hydroponics/biodome)
"mV" = (/obj/structure/flora/ausbushes/fullgrass,/obj/structure/flora/ausbushes/fullgrass,/turf/floor/natural/grass,/area/hydroponics/biodome)
"mX" = (/obj/structure/flora/tree/green/small,/obj/structure/flora/ausbushes/lavendergrass,/turf/floor/natural/grass,/area/hydroponics/biodome)
"oq" = (/obj/structure/flora/ausbushes/lavendergrass,/obj/structure/flora/ausbushes/sunnybush,/obj/machinery/light{dir = 4},/turf/floor/natural/grass,/area/hydroponics/biodome)
"oL" = (/obj/structure/flora/ausbushes/sparsegrass,/obj/machinery/alarm{dir = 4; pixel_x = -24},/obj/structure/flora/jungleplants/junglebushlarge/bush2,/turf/floor/natural/grass,/area/hydroponics/biodome)
"oX" = (/obj/structure/flora/tree/green/small/tree4,/turf/floor/natural/grass,/area/hydroponics/biodome)
"pg" = (/obj/structure/flora/ausbushes/lavendergrass,/obj/machinery/light{dir = 4},/turf/floor/natural/grass,/area/hydroponics/biodome)
"ph" = (/obj/effect/floor_decal/corner/green{dir = 6},/obj/effect/floor_decal/corner/green{dir = 9},/obj/machinery/atmospherics/pipe/simple/hidden/supply{dir = 4},/obj/structure/disposalpipe/segment{dir = 4},/obj/structure/railing/steel{dir = 1},/obj/structure/cable{d1 = 4; d2 = 8; icon_state = "4-8"},/turf/floor/tiled/rough,/area/hydroponics/biodome)
"px" = (/obj/structure/flora/ausbushes/sparsegrass,/obj/machinery/light{dir = 4},/turf/floor/natural/grass,/area/hydroponics/biodome)
"qu" = (/obj/machinery/door/firedoor/border_only,/obj/effect/floor_decal/corner/green{dir = 6},/obj/effect/floor_decal/corner/green{dir = 9},/obj/machinery/door/airlock/glass{name = "Central Biodome"; req_access = list()},/turf/floor/tiled/rough,/area/hydroponics/biodome)
"rx" = (/obj/structure/flora/ausbushes/fullgrass,/obj/structure/flora/ausbushes/grassybush,/turf/floor/natural/grass,/area/hydroponics/biodome)
"sb" = (/obj/structure/flora/ausbushes/lavendergrass,/obj/effect/floor_decal/spline/fancy/wood/corner{dir = 8},/turf/floor/natural/grass,/area/hydroponics/biodome)
"sd" = (/obj/effect/floor_decal/corner/green{dir = 9},/obj/effect/floor_decal/corner/green{dir = 6},/turf/floor/tiled/rough,/area/hydroponics/biodome)
"sB" = (/obj/structure/flora/ausbushes/lavendergrass,/obj/structure/flora/tree/green/tree10,/turf/floor/natural/grass,/area/hydroponics/biodome)
"sP" = (/obj/structure/flora/tree/green/small/tree3,/obj/structure/flora/ausbushes/sparsegrass,/turf/floor/natural/grass,/area/hydroponics/biodome)
"sX" = (/obj/structure/flora/ausbushes/sparsegrass,/obj/machinery/light,/turf/floor/natural/grass,/area/hydroponics/biodome)
"tn" = (/obj/structure/flora/ausbushes/sparsegrass,/obj/structure/flora/tree/green/tree7,/turf/floor/natural/grass,/area/hydroponics/biodome)
"tC" = (/turf/space,/area/space)
"tT" = (/obj/structure/flora/tree/green/small/tree1,/obj/effect/floor_decal/spline/fancy/wood/corner,/turf/floor/natural/grass,/area/hydroponics/biodome)
"ua" = (/obj/structure/flora/ausbushes/fullgrass,/obj/effect/floor_decal/spline/fancy/wood/corner,/turf/floor/natural/grass,/area/hydroponics/biodome)
"uQ" = (/obj/structure/flora/ausbushes/sparsegrass,/obj/structure/flora/ausbushes/leafybush,/turf/floor/natural/grass,/area/hydroponics/biodome)
"uR" = (/obj/structure/flora/ausbushes/lavendergrass,/obj/structure/flora/jungleplants/junglebushlarge/bush4,/obj/effect/floor_decal/spline/fancy/wood/corner{dir = 1},/turf/floor/natural/grass,/area/hydroponics/biodome)
"uU" = (/obj/structure/flora/ausbushes/lavendergrass,/obj/structure/flora/ausbushes/jungleflora/bushc,/turf/floor/natural/grass,/area/hydroponics/biodome)
"uX" = (/obj/effect/floor_decal/corner/green{dir = 5},/obj/effect/floor_decal/corner/green{dir = 10},/obj/machinery/navbeacon/frontier/DOME_N,/turf/floor/tiled/rough,/area/hydroponics/biodome)
"vC" = (/obj/effect/floor_decal/spline/fancy{dir = 1},/obj/machinery/light,/obj/machinery/camera/network/civilian_east{c_tag = "Central Garden - North"; dir = 1},/turf/floor/water/fountain,/area/hydroponics/biodome)
"vP" = (/obj/effect/floor_decal/corner/green{dir = 6},/obj/effect/floor_decal/corner/green{dir = 9},/obj/machinery/atmospherics/pipe/manifold/hidden/supply{dir = 4},/obj/structure/disposalpipe/segment{dir = 2; icon_state = "pipe-c"},/obj/structure/railing/steel{dir = 4},/obj/structure/cable{icon_state = "2-8"},/turf/floor/tiled/rough,/area/hydroponics/biodome)
"vR" = (/obj/effect/floor_decal/corner/green{dir = 6},/obj/effect/floor_decal/corner/green{dir = 9},/obj/machinery/atmospherics/pipe/simple/hidden/scrubbers{dir = 9},/obj/structure/disposalpipe/segment{dir = 8; icon_state = "pipe-c"},/obj/structure/railing/steel{dir = 4},/obj/machinery/navbeacon/frontier/DOME_NW,/turf/floor/tiled/rough,/area/hydroponics/biodome)
"wl" = (/obj/structure/bed/pew/pewchapel/right{dir = 8; name = "bench"},/turf/floor/natural/grass,/area/hydroponics/biodome)
"wp" = (/obj/effect/floor_decal/corner/green{dir = 9},/obj/effect/floor_decal/corner/green{dir = 6},/obj/machinery/atmospherics/pipe/simple/hidden/supply{dir = 4},/obj/structure/disposalpipe/segment{dir = 4},/obj/structure/cable{d1 = 4; d2 = 8; icon_state = "4-8"},/turf/floor/tiled/rough,/area/hydroponics/biodome)
"xn" = (/obj/structure/flora/ausbushes/lavendergrass,/obj/structure/flora/ausbushes/stalkybush,/turf/floor/natural/grass,/area/hydroponics/biodome)
"xq" = (/obj/effect/floor_decal/corner/green{dir = 5},/obj/effect/floor_decal/corner/green{dir = 10},/turf/floor/tiled/rough,/area/hydroponics/biodome)
"xA" = (/obj/structure/flora/ausbushes/sparsegrass,/obj/machinery/firealarm{dir = 8; pixel_x = -24; pixel_y = -2},/obj/structure/flora/ausbushes/jungleflora/busha,/turf/floor/natural/grass,/area/hydroponics/biodome)
"xL" = (/obj/structure/flora/ausbushes/sparsegrass,/obj/structure/flora/ausbushes/ywflowers,/turf/floor/natural/grass,/area/hydroponics/biodome)
"yz" = (/obj/machinery/alarm{dir = 8; pixel_x = 24},/obj/effect/floor_decal/corner/green{dir = 9},/obj/effect/floor_decal/corner/green{dir = 6},/obj/structure/disposalpipe/trunk{dir = 1},/obj/machinery/disposal,/turf/floor/tiled/rough,/area/hydroponics/biodome)
"yJ" = (/obj/structure/flora/ausbushes/stalkybush,/turf/floor/natural/grass,/area/hydroponics/biodome)
"zl" = (/obj/structure/flora/ausbushes/sparsegrass,/turf/floor/natural/grass,/area/hydroponics/biodome)
"Ai" = (/obj/machinery/door/firedoor/border_only,/obj/effect/floor_decal/corner/green{dir = 9},/obj/effect/floor_decal/corner/green{dir = 6},/obj/machinery/door/airlock/glass{name = "Central Biodome"; req_access = list()},/obj/machinery/atmospherics/pipe/simple/hidden/scrubbers{dir = 4},/obj/structure/disposalpipe/segment{dir = 8},/turf/floor/tiled/rough,/area/hydroponics/biodome)
"BG" = (/obj/structure/flora/ausbushes/sparsegrass,/obj/machinery/light{dir = 8},/turf/floor/natural/grass,/area/hydroponics/biodome)
"BI" = (/obj/structure/bed/pew/pewchapel/right{dir = 4; name = "bench"},/turf/floor/natural/grass,/area/hydroponics/biodome)
"Cb" = (/obj/structure/flora/tree/green/tree8,/obj/structure/flora/ausbushes/fullgrass,/turf/floor/natural/grass,/area/hydroponics/biodome)
"CQ" = (/obj/structure/flora/ausbushes/sparsegrass,/obj/structure/flora/ausbushes/jungleplants,/turf/floor/natural/grass,/area/hydroponics/biodome)
"DJ" = (/obj/effect/floor_decal/corner/green{dir = 6},/obj/effect/floor_decal/corner/green{dir = 9},/obj/machinery/atmospherics/pipe/simple/hidden/scrubbers{dir = 6},/obj/structure/disposalpipe/segment{dir = 4; icon_state = "pipe-c"},/turf/floor/tiled/rough,/area/hydroponics/biodome)
"DL" = (/obj/effect/floor_decal/spline/fancy/wood/corner{dir = 1},/turf/floor/natural/grass,/area/hydroponics/biodome)
"Em" = (/obj/structure/bed/pew/pewchapel/left{dir = 8; name = "bench"},/turf/floor/natural/grass,/area/hydroponics/biodome)
"EY" = (/obj/effect/floor_decal/corner/green{dir = 9},/obj/effect/floor_decal/corner/green{dir = 6},/obj/machinery/power/apc{dir = 4; name = "east bump"; pixel_x = 24},/obj/structure/cable/white{icon_state = "0-2"},/turf/floor/tiled/rough,/area/hydroponics/biodome)
"Fb" = (/obj/effect/landmark/event/rift/spawn_point,/turf/wall/gold,/area/hydroponics/biodome)
"Fw" = (/obj/structure/flora/ausbushes/pointybush,/obj/effect/floor_decal/spline/fancy/wood/corner{dir = 8},/turf/floor/natural/grass,/area/hydroponics/biodome)
"FS" = (/obj/structure/flora/ausbushes/lavendergrass,/obj/structure/flora/jungleplants/junglebushlarge/bush1,/turf/floor/natural/grass,/area/hydroponics/biodome)
"II" = (/obj/structure/flora/ausbushes/reedbush,/obj/structure/flora/ausbushes/fullgrass,/turf/floor/natural/grass,/area/hydroponics/biodome)
"Jl" = (/obj/effect/floor_decal/spline/fancy/wood/corner{dir = 4},/turf/floor/natural/grass,/area/hydroponics/biodome)
"JJ" = (/obj/effect/floor_decal/corner/green{dir = 6},/obj/effect/floor_decal/corner/green{dir = 9},/obj/machinery/atmospherics/pipe/simple/hidden/scrubbers{dir = 10},/obj/structure/disposalpipe/segment{dir = 2; icon_state = "pipe-c"},/turf/floor/tiled/rough,/area/hydroponics/biodome)
"KI" = (/obj/structure/window_frame/rglass,/obj/machinery/door/firedoor/border_only,/turf/floor/plating,/area/hydroponics/biodome)
"KJ" = (/obj/effect/floor_decal/spline/fancy{dir = 5},/turf/floor/water/fountain,/area/hydroponics/biodome)
"Lq" = (/obj/effect/floor_decal/spline/fancy,/obj/machinery/light{dir = 1},/obj/machinery/camera/network/civilian_east{c_tag = "Central Garden - South"},/turf/floor/water/fountain,/area/hydroponics/biodome)
"Mo" = (/obj/machinery/door/firedoor/border_only,/obj/effect/floor_decal/corner/green{dir = 9},/obj/effect/floor_decal/corner/green{dir = 6},/obj/machinery/door/airlock/glass{name = "Central Biodome"; req_access = list()},/obj/machinery/atmospherics/pipe/simple/hidden/scrubbers{dir = 4},/obj/structure/cable/white{icon_state = "4-8"},/obj/structure/disposalpipe/segment{dir = 8},/turf/floor/tiled/rough,/area/hydroponics/biodome)
"Mr" = (/obj/structure/flora/ausbushes/lavendergrass,/obj/structure/flora/ausbushes/jungleflora/bushb,/turf/floor/natural/grass,/area/hydroponics/biodome)
"MX" = (/obj/structure/flora/tree/green/tree7,/turf/floor/natural/grass,/area/hydroponics/biodome)
"MY" = (/obj/effect/floor_decal/spline/fancy{dir = 4},/obj/machinery/light{dir = 8},/turf/floor/water/fountain,/area/hydroponics/biodome)
"Nh" = (/obj/structure/flora/ausbushes/lavendergrass,/obj/structure/flora/ausbushes/leafybush,/turf/floor/natural/grass,/area/hydroponics/biodome)
"Oo" = (/obj/structure/flora/ausbushes/lavendergrass,/obj/structure/flora/ausbushes/reedbush,/turf/floor/natural/grass,/area/hydroponics/biodome)
"OM" = (/obj/structure/flora/ausbushes/ywflowers,/turf/floor/natural/grass,/area/hydroponics/biodome)
"Ph" = (/obj/structure/bed/pew/pewchapel/left{dir = 4; name = "bench"},/turf/floor/natural/grass,/area/hydroponics/biodome)
"PY" = (/obj/effect/floor_decal/corner/green{dir = 6},/obj/effect/floor_decal/corner/green{dir = 9},/obj/machinery/atmospherics/pipe/simple/hidden/supply{dir = 5},/obj/structure/disposalpipe/segment{dir = 1; icon_state = "pipe-c"},/obj/structure/cable{d1 = 1; d2 = 4; icon_state = "1-4"},/turf/floor/tiled/rough,/area/hydroponics/biodome)
"Qo" = (/obj/effect/floor_decal/corner/green{dir = 6},/obj/effect/floor_decal/corner/green{dir = 9},/obj/machinery/atmospherics/pipe/simple/hidden/supply{dir = 9},/obj/structure/disposalpipe/segment{dir = 8; icon_state = "pipe-c"},/obj/structure/cable{d1 = 1; d2 = 8; icon_state = "1-8"},/turf/floor/tiled/rough,/area/hydroponics/biodome)
"QE" = (/obj/structure/flora/ausbushes/lavendergrass,/turf/floor/natural/grass,/area/hydroponics/biodome)
"Rn" = (/obj/structure/flora/ausbushes/pointybush,/turf/floor/natural/grass,/area/hydroponics/biodome)
"RB" = (/obj/structure/flora/ausbushes/fullgrass,/obj/structure/flora/jungleplants/alienplant7,/turf/floor/natural/grass,/area/hydroponics/biodome)
"SG" = (/obj/structure/flora/tree/green/tree9,/obj/structure/flora/ausbushes/fullgrass,/turf/floor/natural/grass,/area/hydroponics/biodome)
"SK" = (/obj/effect/floor_decal/corner/green{dir = 6},/obj/effect/floor_decal/corner/green{dir = 9},/obj/machinery/atmospherics/pipe/simple/hidden/scrubbers{dir = 4},/obj/structure/disposalpipe/segment{dir = 8},/turf/floor/tiled/rough,/area/hydroponics/biodome)
"Tb" = (/obj/structure/flora/ausbushes/stalkybush,/obj/structure/flora/ausbushes/fullgrass,/turf/floor/natural/grass,/area/hydroponics/biodome)
"TD" = (/obj/effect/floor_decal/corner/green{dir = 6},/obj/effect/floor_decal/corner/green{dir = 9},/obj/machinery/atmospherics/unary/vent_scrubber/on{dir = 1},/obj/structure/railing/steel{dir = 8},/turf/floor/tiled/rough,/area/hydroponics/biodome)
"TN" = (/obj/effect/floor_decal/spline/fancy{dir = 8},/obj/machinery/light{dir = 4},/turf/floor/water/fountain,/area/hydroponics/biodome)
"Ua" = (/obj/structure/flora/ausbushes/lavendergrass,/obj/effect/floor_decal/spline/fancy/wood/corner{dir = 4},/turf/floor/natural/grass,/area/hydroponics/biodome)
"Ud" = (/obj/effect/floor_decal/spline/fancy{dir = 9},/turf/floor/water/fountain,/area/hydroponics/biodome)
"UD" = (/obj/effect/floor_decal/corner/green{dir = 6},/obj/effect/floor_decal/corner/green{dir = 9},/obj/machinery/atmospherics/pipe/manifold/hidden/scrubbers{dir = 8},/obj/structure/disposalpipe/segment{dir = 1; icon_state = "pipe-c"},/obj/structure/railing/steel{dir = 8},/obj/machinery/navbeacon/frontier/DOME_NE,/turf/floor/tiled/rough,/area/hydroponics/biodome)
"VT" = (/obj/structure/flora/ausbushes/ppflowers,/obj/machinery/hologram/holopad,/turf/floor/natural/grass,/area/hydroponics/biodome)
"WJ" = (/obj/effect/floor_decal/corner/green{dir = 9},/obj/effect/floor_decal/corner/green{dir = 6},/obj/machinery/atmospherics/pipe/simple/hidden/supply{dir = 4},/obj/structure/cable{d1 = 4; d2 = 8; icon_state = "4-8"},/obj/structure/disposalpipe/junction{dir = 8; icon_state = "pipe-j2"},/turf/floor/tiled/rough,/area/hydroponics/biodome)
"WS" = (/obj/structure/flora/ausbushes/fullgrass,/turf/floor/natural/grass,/area/hydroponics/biodome)
"Xg" = (/turf/floor/natural/grass,/area/hydroponics/biodome)
"XJ" = (/turf/wall,/area/hydroponics/biodome)
"XM" = (/obj/effect/floor_decal/spline/fancy{dir = 10},/turf/floor/water/fountain,/area/hydroponics/biodome)
"XN" = (/obj/structure/flora/ausbushes/fullgrass,/obj/machinery/light{dir = 8},/turf/floor/natural/grass,/area/hydroponics/biodome)
"Yr" = (/obj/structure/flora/ausbushes/genericbush,/turf/floor/natural/grass,/area/hydroponics/biodome)
"Yt" = (/obj/structure/flora/ausbushes/sparsegrass,/obj/effect/floor_decal/spline/fancy/wood/corner,/turf/floor/natural/grass,/area/hydroponics/biodome)
"Zo" = (/obj/effect/floor_decal/corner/green{dir = 9},/obj/effect/floor_decal/corner/green{dir = 6},/obj/machinery/atmospherics/pipe/simple/hidden/scrubbers{dir = 4},/obj/structure/cable/white{icon_state = "1-4"},/obj/structure/disposalpipe/segment{dir = 8},/turf/floor/tiled/rough,/area/hydroponics/biodome)
"ZS" = (/obj/structure/flora/ausbushes/lavendergrass,/obj/structure/flora/ausbushes/brflowers,/turf/floor/natural/grass,/area/hydroponics/biodome)
"ZZ" = (/obj/structure/flora/ausbushes/sunnybush,/turf/floor/natural/grass,/area/hydroponics/biodome)

(1,1,1) = {"
tCtCKIKIKIXNtCtCtCtCtCoqKIKIKItCtC
tCKIKIWSWSiYgiTbrxIImVuRXgXgKIKItC
tCKICQUaXgoXedWSxnitXgQEQEDLRBKItC
KIKIBGlHRnYtuQQEQEmfbhsbmXtnpxKIKI
KIzlJluUOoBIuXxqfYxqxqEmQEchDLxLKI
XJoLsPWSsBPhDJbXbXbXJJwljPQEoXEYXJ
AiSKSKSKSKSKvRUdvCKJUDdjdjdjdjZoMo
KIfMZSfMZSVTcLTNFbMYTDVTZSfMZSfMKI
iokUkUkUkUkUvPXMLqmdhkwpwpwpwpWJio
XJxAXgeOQEQEPYphphphQoXgNhlAXgyzXJ
KIzlaJedQEQEYrZZsdeJbyQEQEQEtTyJKI
KIKIXNWSFSWSWSXgsdOoQEeOOMQEpgKIKI
tCKIWSblxLSGWSXgsdMrXgMXQEuaQEKItC
tCKIKIgWsXFwQEeOsdNhcvbYiVSGKIKItC
tCtCKIKIKIzlhHCbsdWSWSrxKIKIKItCtC
tCtCtCtCKIKIKIKIquKIKIKIKItCtCtCtC
"}
