"aj" = (/obj/effect/floor_decal/spline/plain/corner/white{dir = 8},/turf/simulated/floor/tiled/dark/mono,/area/hydroponics/biodome)
"aG" = (/obj/machinery/door/firedoor/border_only,/obj/machinery/door/airlock/glass{name = "Central Biodome"; req_access = list()},/turf/simulated/floor/tiled/white/rough,/area/hydroponics/biodome)
"cO" = (/obj/structure/disposalpipe/segment{dir = 1; icon_state = "pipe-c"},/obj/machinery/atmospherics/pipe/simple/hidden/supply{dir = 5},/obj/structure/cable{d1 = 1; d2 = 4; icon_state = "1-4"},/turf/simulated/floor/tiled/white/rough,/area/hydroponics/biodome)
"dp" = (/obj/machinery/light/he{dir = 4},/obj/item/toy/balloon/nanotrasen{anchored = 1},/turf/simulated/floor/tiled/white/mono,/area/hydroponics/biodome)
"em" = (/obj/structure/disposalpipe/segment{dir = 1; icon_state = "pipe-c"},/obj/machinery/atmospherics/pipe/simple/hidden/scrubbers{dir = 5},/turf/simulated/floor/tiled/white/rough,/area/hydroponics/biodome)
"fP" = (/obj/structure/bed/pew/pewchapel/right{dir = 1; icon_state = "chair_pewchapel_right_over"; name = "bench"},/turf/simulated/floor/tiled/dark/mono,/area/hydroponics/biodome)
"gO" = (/obj/item/stool,/obj/effect/floor_decal/spline/plain/white{dir = 10},/turf/simulated/floor/tiled/dark/mono,/area/hydroponics/biodome)
"hZ" = (/obj/structure/disposalpipe/segment{dir = 8; icon_state = "pipe-c"},/obj/machinery/atmospherics/pipe/simple/hidden/supply{dir = 9; pixel_y = 0},/obj/structure/cable{d1 = 1; d2 = 8; icon_state = "1-8"},/turf/simulated/floor/tiled/white/rough,/area/hydroponics/biodome)
"ic" = (/obj/machinery/light/he,/obj/effect/floor_decal/spline/plain/white{dir = 10},/turf/simulated/floor/tiled/dark/mono,/area/hydroponics/biodome)
"in" = (/obj/machinery/light{dir = 8; icon_state = "tube1"},/turf/simulated/floor/tiled/techfloor/grid,/area/hydroponics/biodome)
"iC" = (/obj/structure/railing{dir = 1; anchored = 1},/obj/structure/railing{dir = 8; anchored = 1},/turf/simulated/floor/tiled/techfloor/grid,/area/hydroponics/biodome)
"iW" = (/obj/machinery/atmospherics/pipe/simple/hidden/supply{dir = 4},/obj/structure/cable{d1 = 4; d2 = 8; icon_state = "4-8"},/obj/structure/disposalpipe/junction{dir = 8; icon_state = "pipe-j2"},/turf/simulated/floor/tiled/white/rough,/area/hydroponics/biodome)
"jW" = (/obj/effect/floor_decal/floordetail/edgedrain{dir = 1},/obj/structure/railing/steel{dir = 1},/obj/machinery/camera/network/civilian_east{c_tag = "Central Garden - West"; dir = 4},/turf/simulated/floor/tiled/dark/mono,/area/hydroponics/biodome)
"lG" = (/turf/simulated/wall/silver,/area/hydroponics/biodome)
"nv" = (/obj/effect/floor_decal/spline/plain/white{dir = 6},/turf/simulated/floor/tiled/dark/mono,/area/hydroponics/biodome)
"pk" = (/obj/structure/railing{dir = 1; anchored = 1},/obj/structure/railing{dir = 4; anchored = 1},/turf/simulated/floor/tiled/techfloor/grid,/area/hydroponics/biodome)
"pD" = (/turf/simulated/floor/tiled/mono,/area/hydroponics/biodome)
"pR" = (/obj/item/stool,/obj/effect/floor_decal/spline/plain/white{dir = 6},/turf/simulated/floor/tiled/dark/mono,/area/hydroponics/biodome)
"qr" = (/obj/item/stool,/obj/effect/floor_decal/spline/plain/white,/turf/simulated/floor/tiled/dark/mono,/area/hydroponics/biodome)
"qx" = (/obj/machinery/door/firedoor/border_only,/obj/machinery/door/airlock/glass{name = "Central Biodome"; req_access = list()},/obj/machinery/atmospherics/pipe/simple/hidden/scrubbers{dir = 4},/obj/structure/cable/white{icon_state = "4-8"},/obj/structure/disposalpipe/segment{dir = 8},/turf/simulated/floor/tiled/white/rough,/area/hydroponics/biodome)
"rh" = (/obj/item/toy/balloon/nanotrasen{anchored = 1},/turf/simulated/floor/tiled/mono,/area/hydroponics/biodome)
"rt" = (/obj/structure/railing{dir = 4; anchored = 1},/turf/simulated/floor/tiled/techfloor/grid,/area/hydroponics/biodome)
"rK" = (/obj/effect/floor_decal/floordetail/edgedrain{dir = 1},/obj/structure/railing/steel{dir = 1},/obj/machinery/camera/network/civilian_east{c_tag = "Central Garden - East"; dir = 8},/turf/simulated/floor/tiled/dark/mono,/area/hydroponics/biodome)
"we" = (/obj/effect/floor_decal/stairs,/turf/simulated/floor/natural/jungle/dirt,/area/hydroponics/biodome)
"wy" = (/obj/machinery/hologram/holopad,/turf/simulated/floor/tiled/dark/mono,/area/hydroponics/biodome)
"xE" = (/obj/structure/bed/pew/pewchapel/right{dir = 1; icon_state = "chair_pewchapel_right_over"; name = "bench"},/obj/effect/floor_decal/spline/plain/corner/white,/turf/simulated/floor/tiled/dark/mono,/area/hydroponics/biodome)
"yh" = (/obj/machinery/firealarm{dir = 8; pixel_x = -24; pixel_y = -2},/obj/machinery/atmospherics/unary/vent_pump/on{dir = 1},/turf/simulated/floor/tiled/white/rough,/area/hydroponics/biodome)
"yj" = (/obj/structure/disposalpipe/segment{dir = 8; icon_state = "pipe-c"},/obj/machinery/atmospherics/pipe/simple/hidden/scrubbers{dir = 9},/turf/simulated/floor/tiled/white/rough,/area/hydroponics/biodome)
"yx" = (/obj/effect/floor_decal/floordetail/edgedrain{dir = 1},/obj/structure/railing/steel{dir = 1},/turf/simulated/floor/tiled/dark/mono,/area/hydroponics/biodome)
"yT" = (/obj/machinery/door/firedoor/border_only,/obj/machinery/door/airlock/glass{name = "Central Biodome"; req_access = list()},/obj/machinery/atmospherics/pipe/simple/hidden/supply{dir = 4},/obj/structure/disposalpipe/segment{dir = 4},/obj/structure/cable{d1 = 4; d2 = 8; icon_state = "4-8"},/turf/simulated/floor/tiled/white/rough,/area/hydroponics/biodome)
"zJ" = (/obj/machinery/door/firedoor/border_only,/obj/machinery/door/airlock/glass{name = "Central Biodome"; req_access = list()},/obj/machinery/atmospherics/pipe/simple/hidden/scrubbers{dir = 4},/obj/structure/disposalpipe/segment{dir = 8},/turf/simulated/floor/tiled/white/rough,/area/hydroponics/biodome)
"Af" = (/obj/machinery/light/he{dir = 8},/obj/item/toy/balloon/nanotrasen{anchored = 1},/turf/simulated/floor/tiled/white/mono,/area/hydroponics/biodome)
"AF" = (/obj/machinery/atmospherics/unary/vent_scrubber/on,/turf/simulated/floor/tiled/white/rough,/area/hydroponics/biodome)
"Ct" = (/turf/simulated/wall,/area/hydroponics/biodome)
"CV" = (/obj/effect/floor_decal/stairs{dir = 4},/turf/simulated/floor/natural/jungle/dirt,/area/hydroponics/biodome)
"DR" = (/obj/effect/floor_decal/spline/plain/corner/white,/turf/simulated/floor/tiled/dark/mono,/area/hydroponics/biodome)
"DW" = (/obj/machinery/power/apc{dir = 4; name = "east bump"; pixel_x = 24},/obj/structure/cable/white{icon_state = "0-2"},/turf/simulated/floor/tiled/white/rough,/area/hydroponics/biodome)
"El" = (/obj/machinery/light{dir = 4; icon_state = "tube1"},/turf/simulated/floor/tiled/mono,/area/hydroponics/biodome)
"EQ" = (/obj/effect/floor_decal/floordetail/edgedrain{dir = 5},/obj/structure/railing/steel{dir = 4; icon_state = "newrailing0"},/turf/simulated/floor/tiled/dark/rough,/area/hydroponics/biodome)
"FN" = (/turf/simulated/floor/tiled/dark/mono,/area/hydroponics/biodome)
"GJ" = (/obj/structure/disposalpipe/segment{dir = 8},/obj/machinery/atmospherics/pipe/simple/hidden/scrubbers{dir = 4},/turf/simulated/floor/tiled/white/rough,/area/hydroponics/biodome)
"HL" = (/obj/effect/floor_decal/spline/plain/white{dir = 4},/turf/simulated/floor/tiled/dark/mono,/area/hydroponics/biodome)
"HU" = (/obj/structure/disposalpipe/segment{dir = 4},/obj/structure/cable{d1 = 4; d2 = 8; icon_state = "4-8"},/obj/machinery/atmospherics/pipe/manifold/hidden/supply{dir = 1},/turf/simulated/floor/tiled/white/rough,/area/hydroponics/biodome)
"Ic" = (/turf/simulated/floor/tiled/techfloor/grid,/area/hydroponics/biodome)
"Il" = (/obj/structure/disposalpipe/segment{dir = 2; icon_state = "pipe-c"},/obj/machinery/atmospherics/pipe/simple/hidden/scrubbers{dir = 10},/turf/simulated/floor/tiled/white/rough,/area/hydroponics/biodome)
"JD" = (/obj/item/stool,/obj/effect/floor_decal/spline/plain/white{dir = 8},/turf/simulated/floor/tiled/dark/mono,/area/hydroponics/biodome)
"Kb" = (/obj/structure/disposalpipe/segment{dir = 4; icon_state = "pipe-c"},/obj/machinery/atmospherics/pipe/simple/hidden/scrubbers{dir = 6},/obj/machinery/navbeacon/frontier/DOME_NE,/turf/simulated/floor/tiled/white/rough,/area/hydroponics/biodome)
"Ke" = (/obj/structure/disposalpipe/segment{dir = 4; icon_state = "pipe-c"},/obj/machinery/atmospherics/pipe/simple/hidden/supply{dir = 6},/obj/structure/cable{d1 = 2; d2 = 4; icon_state = "2-4"},/turf/simulated/floor/tiled/white/rough,/area/hydroponics/biodome)
"Kx" = (/obj/structure/disposalpipe/segment{dir = 2; icon_state = "pipe-c"},/obj/machinery/atmospherics/pipe/simple/hidden/scrubbers{dir = 10},/obj/machinery/navbeacon/frontier/DOME_NW,/turf/simulated/floor/tiled/white/rough,/area/hydroponics/biodome)
"KG" = (/obj/structure/bed/pew/pewchapel/left{dir = 1; icon_state = "chair_pewchapel_left_over"; name = "bench"},/obj/effect/floor_decal/spline/plain/corner/white{dir = 8},/turf/simulated/floor/tiled/dark/mono,/area/hydroponics/biodome)
"KK" = (/obj/machinery/light{dir = 8},/turf/simulated/floor/tiled/mono,/area/hydroponics/biodome)
"Lt" = (/obj/structure/disposalpipe/segment{dir = 8},/obj/machinery/atmospherics/pipe/manifold/hidden/scrubbers,/turf/simulated/floor/tiled/white/rough,/area/hydroponics/biodome)
"Ms" = (/obj/machinery/atmospherics/pipe/simple/hidden/scrubbers{dir = 4},/obj/structure/cable/white{icon_state = "1-4"},/obj/structure/disposalpipe/segment{dir = 8},/turf/simulated/floor/tiled/white/rough,/area/hydroponics/biodome)
"MK" = (/obj/machinery/alarm{dir = 8; pixel_x = 24},/obj/structure/disposalpipe/trunk{dir = 1},/obj/machinery/disposal,/turf/simulated/floor/tiled/white/rough,/area/hydroponics/biodome)
"ML" = (/obj/effect/floor_decal/floordetail/edgedrain{dir = 9},/obj/structure/railing/steel{dir = 8; icon_state = "newrailing0"},/turf/simulated/floor/tiled/dark/rough,/area/hydroponics/biodome)
"NZ" = (/obj/structure/window/reinforced{layer = 7},/obj/structure/window/reinforced{dir = 1; health = 1e+006},/obj/structure/showcase{layer = 6; icon_state = "showcase_5"; desc = "A stand with the mech on it."},/turf/simulated/floor/tiled/white/mono,/area/hydroponics/biodome)
"OT" = (/obj/item/stool,/obj/machinery/light/he,/obj/effect/floor_decal/spline/plain/white{dir = 6},/turf/simulated/floor/tiled/dark/mono,/area/hydroponics/biodome)
"Qt" = (/obj/machinery/light{dir = 4; icon_state = "tube1"},/turf/simulated/floor/tiled/techfloor/grid,/area/hydroponics/biodome)
"Qw" = (/obj/machinery/light/he{dir = 8},/obj/effect/floor_decal/spline/plain/white{dir = 8},/turf/simulated/floor/tiled/dark/mono,/area/hydroponics/biodome)
"QE" = (/obj/structure/window_frame/rglass,/obj/machinery/door/firedoor/border_only,/turf/simulated/floor/plating,/area/hydroponics/biodome)
"Rm" = (/obj/structure/disposalpipe/segment,/obj/machinery/atmospherics/pipe/simple/hidden/scrubbers,/turf/simulated/floor/tiled/white/rough,/area/hydroponics/biodome)
"RQ" = (/obj/structure/railing{dir = 1; anchored = 1},/turf/simulated/floor/tiled/techfloor/grid,/area/hydroponics/biodome)
"RZ" = (/obj/structure/window/reinforced{layer = 7},/obj/structure/window/reinforced{dir = 4},/obj/structure/window/reinforced{dir = 1; health = 1e+006},/obj/structure/showcase{layer = 6; icon_state = "showcase_2"},/turf/simulated/floor/tiled/white/mono,/area/hydroponics/biodome)
"Sq" = (/obj/structure/disposalpipe/segment{dir = 4},/obj/machinery/atmospherics/pipe/simple/hidden/supply{dir = 4},/obj/structure/cable{d1 = 4; d2 = 8; icon_state = "4-8"},/turf/simulated/floor/tiled/white/rough,/area/hydroponics/biodome)
"SI" = (/obj/effect/floor_decal/stairs{dir = 8},/turf/simulated/floor/natural/jungle/dirt,/area/hydroponics/biodome)
"Ty" = (/obj/structure/railing{dir = 8; anchored = 1},/turf/simulated/floor/tiled/techfloor/grid,/area/hydroponics/biodome)
"TY" = (/obj/effect/floor_decal/spline/plain/white{dir = 10},/turf/simulated/floor/tiled/dark/mono,/area/hydroponics/biodome)
"UH" = (/obj/structure/bed/pew/pewchapel/left{dir = 1; icon_state = "chair_pewchapel_left_over"; name = "bench"},/turf/simulated/floor/tiled/dark/mono,/area/hydroponics/biodome)
"VO" = (/obj/machinery/light/he{dir = 4},/obj/effect/floor_decal/spline/plain/white{dir = 4},/turf/simulated/floor/tiled/dark/mono,/area/hydroponics/biodome)
"Wl" = (/turf/simulated/floor/tiled/white/rough,/area/hydroponics/biodome)
"Wt" = (/obj/structure/disposalpipe/segment{dir = 2; icon_state = "pipe-c"},/obj/machinery/atmospherics/pipe/simple/hidden/supply{dir = 10},/obj/structure/cable{icon_state = "2-8"},/turf/simulated/floor/tiled/white/rough,/area/hydroponics/biodome)
"WT" = (/turf/space,/area/space)
"Xk" = (/obj/machinery/atmospherics/pipe/simple/hidden/scrubbers{dir = 4},/obj/structure/disposalpipe/segment{dir = 8},/turf/simulated/floor/tiled/white/rough,/area/hydroponics/biodome)
"XR" = (/obj/structure/window/reinforced{layer = 7},/obj/structure/window/reinforced{dir = 1; health = 1e+006},/obj/structure/showcase{layer = 6; icon_state = "showcase_4"; desc = "A stand with the mech on it."},/turf/simulated/floor/tiled/white/mono,/area/hydroponics/biodome)
"XU" = (/turf/simulated/floor/tiled/white/mono,/area/hydroponics/biodome)
"XZ" = (/obj/structure/disposalpipe/segment{dir = 4; icon_state = "pipe-c"},/obj/machinery/atmospherics/pipe/simple/hidden/scrubbers{dir = 6},/turf/simulated/floor/tiled/white/rough,/area/hydroponics/biodome)
"Zi" = (/obj/structure/window/reinforced{layer = 7},/obj/structure/window/reinforced{dir = 1; health = 1e+006},/obj/structure/showcase{layer = 6; icon_state = "showcase_3"},/obj/structure/window/reinforced{dir = 8},/turf/simulated/floor/tiled/white/mono,/area/hydroponics/biodome)
"ZV" = (/obj/structure/disposalpipe/segment{dir = 4},/obj/machinery/atmospherics/pipe/simple/hidden/scrubbers{dir = 4},/turf/simulated/floor/tiled/white/rough,/area/hydroponics/biodome)

(1,1,1) = {"
WTWTQEQElGAfWTWTWTWTWTdplGQEQEWTWT
WTQEQEpDSIXUXUXUXUXUXUXUCVpDQEQEWT
WTQErhpDSIXUXUXUXUXUXUXUCVpDrhQEWT
QEQEKKpDSIXUXUXUXUXUXUXUCVpDElQEQE
QEEQwewelGjWyxyxyxyxyxrKlGweweMLQE
CtAFWlWlJDFNUHfPFNUHfPFNHLWlWlDWCt
zJLtXkKxicajUHfPwyUHfPDROTKbGJMsqx
QEXRRZRmCtQwUHfPFNUHfPVOCtRmZiNZQE
yTHUWtemIlTYKGfPFNUHxEnvXZyjKeiWyT
CtyhcOWtemIlTYajFNDRnvXZyjKehZMKCt
QERQpkcOWtemIlgOqrpRXZyjKehZiCRQQE
QEQEinpkcOWtemZVZVZVyjKehZiCQtQEQE
WTQEIcIcpkcOSqSqSqSqSqhZiCIcIcQEWT
WTQEQEIcIcRQRQpkWliCRQRQIcIcQEQEWT
WTWTQEQEQEIcIcrtWlTyIcIcQEQEQEWTWT
WTWTWTWTQEQEQEQEaGQEQEQEQEWTWTWTWT
"}
