"aJ" = (/obj/structure/flora/tree/pine,/turf/floor/natural/snow,/area/hydroponics/biodome)
"bl" = (/obj/effect/floor_decal/corner/blue/full,/obj/effect/floor_decal/snow,/obj/effect/floor_decal/snowedge{dir = 1},/turf/floor/tiled/rough,/area/hydroponics/biodome)
"by" = (/obj/structure/bed/pew/pewchapel/right{dir = 1; icon_state = "chair_pewchapel_right_over"; name = "bench"},/turf/floor/natural/snow,/area/hydroponics/biodome)
"bX" = (/obj/machinery/atmospherics/pipe/simple/hidden/scrubbers{dir = 4},/obj/structure/disposalpipe/segment{dir = 8},/obj/effect/floor_decal/corner/blue/full,/obj/effect/floor_decal/snow,/turf/floor/tiled/rough,/area/hydroponics/biodome)
"cL" = (/obj/machinery/atmospherics/unary/vent_pump/on{layer = 2.4; level = 2},/obj/structure/railing/steel{dir = 4},/obj/effect/floor_decal/corner/blue/full,/obj/effect/floor_decal/snow,/obj/effect/floor_decal/snowedge{dir = 8},/turf/floor/tiled/rough,/area/hydroponics/biodome)
"eJ" = (/obj/structure/bed/pew/pewchapel/left{dir = 1; icon_state = "chair_pewchapel_left_over"; name = "bench"},/turf/floor/natural/snow,/area/hydroponics/biodome)
"fM" = (/obj/structure/flora/ausbushes/lavendergrass,/turf/floor/natural/snow,/area/hydroponics/biodome)
"fY" = (/obj/effect/floor_decal/corner/blue/full,/obj/effect/floor_decal/snow,/obj/effect/floor_decal/plaque,/obj/effect/floor_decal/snowedge{dir = 1},/obj/structure/flora/tree/pine/xmas,/turf/floor/tiled/rough,/area/hydroponics/biodome)
"gi" = (/obj/effect/floor_decal/corner/blue/full,/obj/effect/floor_decal/snow,/obj/effect/floor_decal/snowedge{dir = 1},/obj/item/storage/backpack/santabag,/obj/item/clothing/suit/space/santa,/obj/item/clothing/head/helmet/space/santahat,/turf/floor/tiled/rough,/area/hydroponics/biodome)
"hk" = (/obj/machinery/atmospherics/pipe/simple/hidden/supply{dir = 6},/obj/structure/disposalpipe/segment{dir = 4; icon_state = "pipe-c"},/obj/structure/railing/steel{dir = 8},/obj/structure/cable{d1 = 2; d2 = 4; icon_state = "2-4"},/obj/effect/floor_decal/corner/blue/full,/obj/effect/floor_decal/snow,/obj/effect/floor_decal/snowedge/corner{dir = 1},/turf/floor/tiled/rough,/area/hydroponics/biodome)
"hH" = (/obj/structure/flora/grass/brown,/turf/floor/natural/snow,/area/hydroponics/biodome)
"io" = (/obj/machinery/door/firedoor/border_only,/obj/machinery/door/airlock/glass{name = "Central Biodome"; req_access = list()},/obj/machinery/atmospherics/pipe/simple/hidden/supply{dir = 4},/obj/structure/disposalpipe/segment{dir = 4},/obj/structure/cable{d1 = 4; d2 = 8; icon_state = "4-8"},/obj/effect/floor_decal/corner/blue/full,/turf/floor/tiled/rough,/area/hydroponics/biodome)
"iV" = (/obj/machinery/light,/turf/floor/natural/snow,/area/hydroponics/biodome)
"kU" = (/obj/machinery/atmospherics/pipe/simple/hidden/supply{dir = 4},/obj/structure/disposalpipe/segment{dir = 4},/obj/structure/cable{d1 = 4; d2 = 8; icon_state = "4-8"},/obj/effect/floor_decal/corner/blue/full,/obj/effect/floor_decal/snow,/obj/effect/floor_decal/snowedge{dir = 1},/obj/effect/floor_decal/snowedge,/turf/floor/tiled/rough,/area/hydroponics/biodome)
"lH" = (/obj/machinery/atmospherics/pipe/simple/hidden/supply{dir = 4},/obj/structure/disposalpipe/segment{dir = 4},/obj/structure/cable{d1 = 4; d2 = 8; icon_state = "4-8"},/obj/effect/floor_decal/corner/blue/full,/obj/effect/floor_decal/snow,/obj/effect/floor_decal/snowedge,/turf/floor/tiled/rough,/area/hydroponics/biodome)
"md" = (/obj/effect/floor_decal/spline/fancy{dir = 6},/turf/floor/natural/ice,/area/hydroponics/biodome)
"oq" = (/obj/machinery/light{dir = 4},/obj/structure/flora/grass/brown,/turf/floor/natural/snow,/area/hydroponics/biodome)
"pg" = (/obj/machinery/light{dir = 4},/obj/structure/flora/tree/pine,/turf/floor/natural/snow,/area/hydroponics/biodome)
"ph" = (/obj/machinery/atmospherics/pipe/simple/hidden/supply{dir = 4},/obj/structure/disposalpipe/segment{dir = 4},/obj/structure/cable{d1 = 4; d2 = 8; icon_state = "4-8"},/obj/effect/floor_decal/corner/blue/full,/obj/effect/floor_decal/snow,/obj/effect/floor_decal/snowedge/corner{dir = 8},/turf/floor/tiled/rough,/area/hydroponics/biodome)
"px" = (/obj/machinery/light{dir = 4},/turf/floor/natural/snow,/area/hydroponics/biodome)
"qu" = (/obj/machinery/door/firedoor/border_only,/obj/machinery/door/airlock/glass{name = "Central Biodome"; req_access = list()},/obj/effect/floor_decal/corner/blue/full,/turf/floor/tiled/rough,/area/hydroponics/biodome)
"rx" = (/obj/structure/flora/tree/dead/deadtree_6,/turf/floor/natural/snow,/area/hydroponics/biodome)
"sb" = (/obj/structure/flora/grass/both,/turf/floor/natural/snow,/area/hydroponics/biodome)
"sd" = (/obj/effect/floor_decal/corner/blue/full,/obj/effect/floor_decal/snow,/obj/effect/floor_decal/snowedge{dir = 8},/obj/effect/floor_decal/snowedge{dir = 4},/turf/floor/tiled/rough,/area/hydroponics/biodome)
"sX" = (/obj/machinery/light,/obj/structure/flora/grass/both,/turf/floor/natural/snow,/area/hydroponics/biodome)
"uX" = (/obj/machinery/navbeacon/frontier/DOME_N,/obj/effect/floor_decal/corner/blue/full,/obj/effect/floor_decal/snow,/obj/effect/floor_decal/snowedge{dir = 9},/turf/floor/tiled/rough,/area/hydroponics/biodome)
"vC" = (/obj/effect/floor_decal/spline/fancy{dir = 1},/obj/machinery/light,/obj/machinery/camera/network/civilian_east{c_tag = "Central Garden - North"; dir = 1},/turf/floor/natural/ice,/area/hydroponics/biodome)
"vP" = (/obj/machinery/atmospherics/pipe/manifold/hidden/supply{dir = 4},/obj/structure/disposalpipe/segment{dir = 2; icon_state = "pipe-c"},/obj/structure/railing/steel{dir = 4},/obj/structure/cable{icon_state = "2-8"},/obj/effect/floor_decal/corner/blue/full,/obj/effect/floor_decal/snow,/obj/effect/floor_decal/snowedge/corner{dir = 8},/obj/effect/floor_decal/snowedge/corner{dir = 4},/turf/floor/tiled/rough,/area/hydroponics/biodome)
"vR" = (/obj/machinery/atmospherics/pipe/simple/hidden/scrubbers{dir = 9},/obj/structure/disposalpipe/segment{dir = 8; icon_state = "pipe-c"},/obj/structure/railing/steel{dir = 4},/obj/machinery/navbeacon/frontier/DOME_NW,/obj/effect/floor_decal/corner/blue/full,/obj/effect/floor_decal/snow,/obj/effect/floor_decal/snowedge/corner{dir = 8},/obj/effect/floor_decal/snowedge/corner{dir = 4},/turf/floor/tiled/rough,/area/hydroponics/biodome)
"wl" = (/obj/structure/bed/pew/pewchapel/right{dir = 8; name = "bench"},/turf/floor/natural/snow,/area/hydroponics/biodome)
"wp" = (/obj/machinery/atmospherics/pipe/simple/hidden/supply{dir = 4},/obj/structure/disposalpipe/segment{dir = 4},/obj/structure/cable{d1 = 4; d2 = 8; icon_state = "4-8"},/obj/effect/floor_decal/corner/blue/full,/obj/effect/floor_decal/snow,/obj/effect/floor_decal/snowedge,/obj/effect/floor_decal/snowedge{dir = 1},/turf/floor/tiled/rough,/area/hydroponics/biodome)
"xq" = (/obj/effect/floor_decal/corner/blue/full,/obj/effect/floor_decal/snow,/obj/effect/floor_decal/snowedge{dir = 5},/turf/floor/tiled/rough,/area/hydroponics/biodome)
"xA" = (/obj/machinery/firealarm{dir = 8; pixel_x = -24; pixel_y = -2},/obj/structure/flora/grass/brown,/turf/floor/natural/snow,/area/hydroponics/biodome)
"yz" = (/obj/machinery/alarm{dir = 8; pixel_x = 24},/obj/structure/disposalpipe/trunk{dir = 1},/obj/machinery/disposal,/obj/effect/floor_decal/corner/blue/full,/obj/effect/floor_decal/snow,/obj/effect/floor_decal/snowedge{dir = 10},/turf/floor/tiled/rough,/area/hydroponics/biodome)
"Ai" = (/obj/machinery/door/firedoor/border_only,/obj/machinery/door/airlock/glass{name = "Central Biodome"; req_access = list()},/obj/machinery/atmospherics/pipe/simple/hidden/scrubbers{dir = 4},/obj/structure/disposalpipe/segment{dir = 8},/obj/effect/floor_decal/corner/blue/full,/turf/floor/tiled/rough,/area/hydroponics/biodome)
"BG" = (/obj/machinery/light{dir = 8},/turf/floor/natural/snow,/area/hydroponics/biodome)
"DJ" = (/obj/machinery/atmospherics/pipe/simple/hidden/scrubbers{dir = 6},/obj/structure/disposalpipe/segment{dir = 4; icon_state = "pipe-c"},/obj/effect/floor_decal/corner/blue/full,/obj/effect/floor_decal/snow,/obj/effect/floor_decal/snowedge{dir = 8},/turf/floor/tiled/rough,/area/hydroponics/biodome)
"Em" = (/obj/structure/bed/pew/pewchapel/left{dir = 8; name = "bench"},/turf/floor/natural/snow,/area/hydroponics/biodome)
"EY" = (/obj/machinery/power/apc{dir = 4; name = "east bump"; pixel_x = 24},/obj/structure/cable/white{icon_state = "0-2"},/obj/effect/floor_decal/corner/blue/full,/obj/effect/floor_decal/snow,/obj/effect/floor_decal/snowedge{dir = 9},/turf/floor/tiled/rough,/area/hydroponics/biodome)
"Fb" = (/obj/effect/landmark/event/rift/spawn_point,/turf/wall/gold,/area/hydroponics/biodome)
"JJ" = (/obj/machinery/atmospherics/pipe/simple/hidden/scrubbers{dir = 10},/obj/structure/disposalpipe/segment{dir = 2; icon_state = "pipe-c"},/obj/effect/floor_decal/corner/blue/full,/obj/effect/floor_decal/snow,/obj/effect/floor_decal/snowedge{dir = 4},/turf/floor/tiled/rough,/area/hydroponics/biodome)
"KI" = (/obj/structure/window_frame/rglass,/obj/machinery/door/firedoor/border_only,/turf/floor/plating,/area/hydroponics/biodome)
"KJ" = (/obj/effect/floor_decal/spline/fancy{dir = 5},/turf/floor/natural/ice,/area/hydroponics/biodome)
"Lq" = (/obj/effect/floor_decal/spline/fancy,/obj/machinery/light{dir = 1},/obj/machinery/camera/network/civilian_east{c_tag = "Central Garden - South"},/turf/floor/natural/ice,/area/hydroponics/biodome)
"Mo" = (/obj/machinery/door/firedoor/border_only,/obj/machinery/door/airlock/glass{name = "Central Biodome"; req_access = list()},/obj/machinery/atmospherics/pipe/simple/hidden/scrubbers{dir = 4},/obj/structure/cable/white{icon_state = "4-8"},/obj/structure/disposalpipe/segment{dir = 8},/obj/effect/floor_decal/corner/blue/full,/turf/floor/tiled/rough,/area/hydroponics/biodome)
"MY" = (/obj/effect/floor_decal/spline/fancy{dir = 4},/obj/machinery/light{dir = 8},/turf/floor/natural/ice,/area/hydroponics/biodome)
"Nh" = (/turf/floor/natural/snow,/area/hydroponics/biodome)
"Oo" = (/obj/structure/flora/tree/dead/deadtree_5,/turf/floor/natural/snow,/area/hydroponics/biodome)
"PY" = (/obj/machinery/atmospherics/pipe/simple/hidden/supply{dir = 5},/obj/structure/disposalpipe/segment{dir = 1; icon_state = "pipe-c"},/obj/structure/cable{d1 = 1; d2 = 4; icon_state = "1-4"},/obj/effect/floor_decal/corner/blue/full,/obj/effect/floor_decal/corner/blue/full,/obj/effect/floor_decal/snow,/obj/effect/floor_decal/snowedge{dir = 10},/turf/floor/tiled/rough,/area/hydroponics/biodome)
"Qo" = (/obj/machinery/atmospherics/pipe/simple/hidden/supply{dir = 9},/obj/structure/disposalpipe/segment{dir = 8; icon_state = "pipe-c"},/obj/structure/cable{d1 = 1; d2 = 8; icon_state = "1-8"},/obj/effect/floor_decal/corner/blue/full,/obj/effect/floor_decal/snow,/obj/effect/floor_decal/snowedge{dir = 4},/obj/effect/floor_decal/snowedge{dir = 6},/turf/floor/tiled/rough,/area/hydroponics/biodome)
"QE" = (/obj/structure/flora/bush,/turf/floor/natural/snow,/area/hydroponics/biodome)
"RB" = (/obj/structure/christmas/snowman,/turf/floor/natural/snow,/area/hydroponics/biodome)
"SK" = (/obj/machinery/atmospherics/pipe/simple/hidden/scrubbers{dir = 4},/obj/structure/disposalpipe/segment{dir = 8},/obj/effect/floor_decal/corner/blue/full,/obj/effect/floor_decal/snow,/obj/effect/floor_decal/snowedge{dir = 1},/obj/effect/floor_decal/snowedge,/turf/floor/tiled/rough,/area/hydroponics/biodome)
"SR" = (/turf/space,/area/space)
"TD" = (/obj/machinery/atmospherics/unary/vent_scrubber/on{dir = 1},/obj/structure/railing/steel{dir = 8},/obj/effect/floor_decal/corner/blue/full,/obj/effect/floor_decal/snow,/obj/effect/floor_decal/snowedge{dir = 4},/turf/floor/tiled/rough,/area/hydroponics/biodome)
"TN" = (/obj/effect/floor_decal/spline/fancy{dir = 8},/obj/machinery/light{dir = 4},/turf/floor/natural/ice,/area/hydroponics/biodome)
"Ud" = (/obj/effect/floor_decal/spline/fancy{dir = 9},/turf/floor/natural/ice,/area/hydroponics/biodome)
"UD" = (/obj/machinery/atmospherics/pipe/manifold/hidden/scrubbers{dir = 8},/obj/structure/disposalpipe/segment{dir = 1; icon_state = "pipe-c"},/obj/structure/railing/steel{dir = 8},/obj/machinery/navbeacon/frontier/DOME_NE,/obj/effect/floor_decal/corner/blue/full,/obj/effect/floor_decal/snow,/obj/effect/floor_decal/snowedge/corner{dir = 1},/obj/effect/floor_decal/snowedge/corner,/turf/floor/tiled/rough,/area/hydroponics/biodome)
"VT" = (/obj/machinery/hologram/holopad,/turf/floor/natural/snow,/area/hydroponics/biodome)
"WJ" = (/obj/machinery/atmospherics/pipe/simple/hidden/supply{dir = 4},/obj/structure/cable{d1 = 4; d2 = 8; icon_state = "4-8"},/obj/structure/disposalpipe/junction{dir = 8; icon_state = "pipe-j2"},/obj/effect/floor_decal/corner/blue/full,/obj/effect/floor_decal/snow,/obj/effect/floor_decal/snowedge/corner{dir = 8},/obj/effect/floor_decal/snowedge{dir = 1},/turf/floor/tiled/rough,/area/hydroponics/biodome)
"WS" = (/obj/structure/flora/tree/dead/deadtree_2,/turf/floor/natural/snow,/area/hydroponics/biodome)
"Xg" = (/obj/structure/flora/tree/dead/deadtree_0,/turf/floor/natural/snow,/area/hydroponics/biodome)
"XJ" = (/turf/wall,/area/hydroponics/biodome)
"XM" = (/obj/effect/floor_decal/spline/fancy{dir = 10},/turf/floor/natural/ice,/area/hydroponics/biodome)
"Zo" = (/obj/machinery/atmospherics/pipe/simple/hidden/scrubbers{dir = 4},/obj/structure/cable/white{icon_state = "1-4"},/obj/structure/disposalpipe/segment{dir = 8},/obj/effect/floor_decal/corner/blue/full,/obj/effect/floor_decal/snow,/obj/effect/floor_decal/snowedge/corner{dir = 4},/obj/effect/floor_decal/snowedge,/turf/floor/tiled/rough,/area/hydroponics/biodome)

(1,1,1) = {"
SRSRKIKIKIBGSRSRSRSRSRoqKIKIKISRSR
SRKIKINhNhhHNhNhhHNhNhNhNhNhKIKISR
SRKIRBhHaJNhNhWSNhNhhHNhNhhHRBKISR
KIKIBGNhNhNhhHNhhHhHNhsbaJNhpxKIKI
KINhNhsbOoNhuXblfYgixqEmNhsbXgNhKI
XJNhaJhHhHNhDJbXbXbXJJwlQEhHNhEYXJ
AiSKSKSKSKSKvRUdvCKJUDSKSKSKSKZoMo
KIfMfMfMfMVTcLTNFbMYTDVTfMfMfMfMKI
iokUkUkUkUkUvPXMLqmdhkwpwpwpwpWJio
XJxANhNhQERBPYlHphlHQohHNhNhNhyzXJ
KINhaJhHNhXgNhhHsdeJbyaJNhhHhHNhKI
KIKIBGNhNhNhNhNhsdOoNhNhsbNhpgKIKI
SRKINhhHNhNhNhsbsdsbNhNhNhRBNhKISR
SRKIKINhsXaJhHNhsdNhNhhHiVhHKIKISR
SRSRKIKIKINhhHNhsdsbNhrxKIKIKISRSR
SRSRSRSRKIKIKIKIquKIKIKIKISRSRSRSR
"}
