"a" = (/turf/simulated/mineral,/area/space)
"c" = (/turf/simulated/floor/plating,/area/space)
"C" = (/turf/simulated/open,/area/space)
"I" = (/turf/simulated/wall,/area/space)
"Z" = (/turf/simulated/floor/asteroid,/area/space)

(1,1,1) = {"
aaaaaaaaaIIIIIIIIIIIIIIIIaaaaaaaaaaaaaaa
aaaaaaaaaIccccIcccIccccIccccccccZaaaaaaa
aIIIIIIIIIccccIcccIccccIccccccIcZaaaaaaa
aIccIccccIccccIcccIccccIccccccIcZaaaaaaa
aIcccccccIccccIcccIccccIccccccIcZZaaaaaa
aIccIccccIccccIcccIccccIIIIIIIIcccaaaaaa
aIccIIIIIIIcIIIcccIIcIIIccccccIcccccccaa
aIccIccccIcccccccccccccIccccccIcccccccaa
aIcccccccIcccccccccccccIccccccIccIccccaa
aIccIccccIcccccccccccccIccccccIccIIIccca
aIIcIIIIIIcccIIcccIIcccIccccccIcccccccca
aIccccIccIcccIcccccIcccIccIcIIIcccccZZca
aIccccccccccccccccccccccccccccccIcccZZca
aIccccccccccccccccccccccccccccccccccccca
aIccccIccIcccIcccccIcccIIIIcccccIccZZZca
aIIcIIIIIIcccIIcccIIcccIccZZZZccccccccca
aIccIccccIcccccccccccccIccZZZZIIcccaaaZa
aIcccccccIcccccccccccccIccZZZZcccccZaaZa
aIccIccccIcccccccccccccIccccccZZccIZaZZa
aIccIIIIIIIccIIIIIIIccIIIIIIccZZccIZZZZa
aIccIccccIccccccccccccccIcccZcccccIZZZZa
aIcccccccIccccccccccccccccccZcccIcIZZZZa
aIccIccccIcccccCCCccccccIcccZcccIcZZZaaa
aIccIIIIIIccccCCCCCIIIcIIIccccccIcZZZaaa
aIccIccccIcccCCCCCCCcccccIcZZcccIcZZaaaa
aIcccccccIccCCCCCCCCCccccIcZZcccIcccaaaa
aIccIccccIcCCCCCCCCCCCcccIcZZcIIIIcaaaaa
aIccIIIIIIcCCCCCCCCCCCIccIcZZcccccZaaZaa
aIccIcccIccCCCCCCCCCCCcccIccZZZZccZZZZaa
aIIIIcccccccCCCCCCCCCccccIccZZZZcIccZZZa
accccZcccccccCCCCCCCcccccIcZZaZZcIccZZZa
aZZZccccIIcIIICCCCCIcccccIcZZaZZaIccZZZa
aZZZZZZcIcccIccCCCcIccIIIIcZaaZZaIcZZZZa
acccZZccIcccIcccccccccIccccZZZZZaIcZZZaa
accIZZccIcccIccccccIccIccZZZZZZZacccZZaa
accIZZccIIcIIIIIIIIIIIIccZZZZaZZZcccZZaa
accIccZcccccaacccccccccccZZZaaZZZcZZZaaa
aZcIccZZZZZcaaZZZZZZZZcccccaaaaaacZZZaaa
aacIIIIIIIcaaaaaaaaaZZcZZZIIIIIIIcccZaaa
aaaaaaaaaaaaaaaaaaaaaaaaaaaaaaaaaaaaaaaa
"}
