"a" = (/turf/simulated/mineral,/area/space)
"b" = (/obj/structure/lattice,/turf/simulated/floor/plating{icon_state = "dmg1"},/area/space)
"c" = (/obj/effect/decal/cleanable/greenglow,/turf/simulated/floor/plating{icon_state = "dmg2"},/area/space)
"h" = (/obj/structure/girder,/turf/simulated/floor/plating{icon_state = "dmg2"},/area/space)
"j" = (/turf/simulated/mineral/random{mineralSpawnChanceList = list("uranium" = 100, "platinum" = 0, "iron" = 0, "carbon" = 0, "diamond" = 0, "gold" = 0, "silver" = 0, "plasma" = 0)},/area/space)
"k" = (/turf/simulated/floor/asteroid,/area/space)
"l" = (/obj/item/ore/uranium,/turf/simulated/floor/plating{icon_state = "dmg1"},/area/space)
"m" = (/obj/structure/girder,/turf/simulated/floor/plating{icon_state = "dmg1"},/area/space)
"q" = (/turf/simulated/floor/plating{icon_state = "dmg2"},/area/space)
"r" = (/turf/simulated/wall/ironplasma,/area/space)
"s" = (/turf/simulated/floor/plating,/area/space)
"t" = (/turf/simulated/wall/voxshuttle,/area/space)
"u" = (/obj/structure/window_frame/reinforced/thermal,/turf/simulated/floor/asteroid,/area/space)
"v" = (/turf/simulated/floor/plating{icon_state = "dmg4"},/area/space)
"x" = (/turf/simulated/floor/plating{icon_state = "dmg3"},/area/space)
"y" = (/obj/structure/door_assembly,/turf/simulated/floor/plating{icon_state = "dmg1"},/area/space)
"A" = (/turf/unsimulated/floor/liquid_plasma,/area/space)
"D" = (/obj/structure/window_frame/reinforced/thermal,/turf/simulated/floor/plating{icon_state = "dmg1"},/area/space)
"E" = (/turf/unsimulated/floor/shuttle_ceiling,/area/space)
"G" = (/obj/effect/decal/cleanable/greenglow,/turf/simulated/floor/plating{icon_state = "dmg3"},/area/space)
"J" = (/obj/effect/decal/cleanable/greenglow,/turf/simulated/floor/plating{icon_state = "dmg1"},/area/space)
"K" = (/obj/machinery/door/airlock/plasma{name = "Strange Airlock"},/turf/simulated/floor/plating{icon_state = "dmg1"},/area/space)
"L" = (/obj/item/material/shard,/turf/simulated/floor/plating{icon_state = "dmg1"},/area/space)
"N" = (/turf/simulated/floor/plating{icon_state = "dmg1"},/area/space)
"O" = (/obj/structure/girder,/turf/simulated/floor/plating{icon_state = "dmg3"},/area/space)
"P" = (/turf/simulated/wall/iron,/area/space)
"Q" = (/obj/item/ore/uranium,/turf/simulated/floor/plating{icon_state = "dmg2"},/area/space)
"R" = (/obj/item/material/shard,/turf/simulated/floor/plating{icon_state = "dmg3"},/area/space)
"S" = (/turf/simulated/floor/natural,/area/space)
"U" = (/obj/structure/table/glass/plass,/turf/simulated/floor/plating{icon_state = "dmg1"},/area/space)
"V" = (/obj/item/ore/uranium,/obj/effect/decal/cleanable/greenglow,/turf/simulated/floor/plating{icon_state = "dmg1"},/area/space)
"W" = (/obj/item/ore/uranium,/obj/effect/decal/cleanable/greenglow,/turf/simulated/floor/plating{icon_state = "dmg3"},/area/space)
"X" = (/obj/item/ore/uranium,/turf/simulated/floor/plating{icon_state = "dmg3"},/area/space)
"Y" = (/obj/item/frame/light{dir = 4; pixel_x = 14},/obj/structure/stairs/north,/turf/simulated/floor/plating{icon_state = "dmg1"},/area/space)
"Z" = (/obj/structure/computerframe,/turf/simulated/floor/plating{icon_state = "dmg1"},/area/space)

(1,1,1) = {"
aaaaaaaaaaaaaaaaaaaaaaaaaaaaaaaaaaaaaaaa
akkkkkkkkkkkkkkkkkkkkkkNNNNNkkkrrrrrrrra
akkkkkkkkkkkkkkkAkkkkkNsssNNNNNrNNNNNNra
akkkkkkkkkAkkkkAAkkkkkNsSSsNNNNNNNsssNra
akkkAkkkkkAAkkkAAAkkkkNNSSsNNNNrrrrNNNra
akkAAAkkkAAAAkAAAAkAAkNNNNsNkkkkkkrNsNra
akAAAAAAkAAAAAAAAAAAAAkNNNNNkkkAAkrNsNra
aAAAAAAAAAAAAAAAAAAAAAkkkkkkkAAAAkrNNNra
aAAAAAAAAAAAAAAAAAAAAAAkkkkAAAAAAArrNrra
aAAAAAAAAAAAAAAAAAAAkAAAkkAAAAAAAkkkkkka
akAAAAAAAAAAAAAAAAkkkkAAAAAAAAAAArrNNrra
akAAAAAAAAAAAAAAAkkkkkkAAAAAAkAAADNNNNra
akkAAAkkkkkAAAkkkkkkkkAAAAkAAkkkADNssNra
akkkkkkkkkkkkkkkkkkkkkAAAAkkkkkAArrssrra
akkkkkkkkkkkkkkkkkkkkkkAAAkkkkAAAkkkkkka
akkkkkkkkkAAkkkAAkkkkkkkkkkkkkAAAkkkkkka
akkkkkkkkAAAAAAAkkkkDuDkkkkkkAAAArrNNrra
akkkkkkkkkkAAAAkkkkDDNDDkkkkkkAAADNssNra
akkkkkkkkkkAAAAAkkkDNsNDkkkkkkAAADsNsNra
akkkkkkkkkkkAAAAAAkrNsNrkkkAAkkkkrrssrra
akkkkkkkkkAAAAkkkkkrNNNrkkAAAkkkkkkkkkka
akkkkkkkkkkkkkkkrrrrNNNrkkkAAAkkkkkkkkka
akkkkkkkkkkkkkNmrNNNNNNrkkkAAAkkkrrNNrra
akkkkkkkkNNmmNxNxqxNNrmrkkkkkAAkkDNNNNra
arrKrrNNLNlNNLWqNqrmmrkkkkkkkkAAADNNNNra
arssNrNNNNJNxNNNNNhNNrkkkrDDDrkkArrNNrra
arssNrNNNqNjxNNNyNNNNNkkkrZZZrNkkkkkkkka
arNNNrrrmNjjqVNNXNOxNrkkkrNsNrNNNNrrNrra
arsssNsNmJjxNNqNNGNxNrkkkrNsNrNNNNrNNNra
arsssNNNmNNNjNLXqXmqNrrrrrKPKrrNNNrNNNra
arsssrrrrlJqjajNLNXNNNNNrNNNNNrrDDrrNrra
arNssrkkkNjaaaajcNqVNNNNrNssNNrNNNNNNNra
arNssrkkkNjaaajNxxaqNNlNrNsssNKNNNsssNra
arrKrrkkkRNjajmQaaabmNNNKNsssNrNNNsssNra
akkkkkkkkkkxNNRNaaNNmNNNrNNNNrtDDDtNNNra
akkkkkkkkkkNNNNNNxNNaaaarraKrrtEEEtNNNra
akkkkkkkkkkNxNNxNNNNamaYraaNUrtEEEtNNNra
akkkkkkkkkkNNmmmNNaaPNxNraNqNrtttttNNNra
akkkkkkkkkkkkkkkkaaaaaaNNNNvarrrrrrrrrra
aaaaaaaaaaaaaaaaaaaaaaaaaaaaaaaaaaaaaaaa
"}
