"aa" = (/turf/space,/area)
"ab" = (/turf/simulated/wall,/area)
"ac" = (/turf/simulated/floor,/area)
"ad" = (/obj/machinery/computer/lasercon{id = "north"},/turf/simulated/floor,/area)
"ae" = (/obj/machinery/computer/lasercon{id = "south"},/turf/simulated/floor,/area)
"af" = (/obj/machinery/computer/lasercon{id = "east"},/turf/simulated/floor,/area)
"ag" = (/obj/machinery/computer/lasercon{id = "west"},/turf/simulated/floor,/area)
"ah" = (/turf/simulated/wall/r_wall,/area)
"ai" = (/obj/lattice,/turf/space,/area)
"aj" = (/obj/landmark/start{name = "Station Engineer"},/turf/simulated/floor,/area)
"ak" = (/obj/machinery/atmospherics/unary/cold_sink/freezer,/turf/simulated/floor,/area)
"al" = (/obj/machinery/atmospherics/pipe/tank/carbon_dioxide,/turf/simulated/floor,/area)
"am" = (/obj/landmark/start,/turf/simulated/floor,/area)
"an" = (/obj/machinery/atmospherics/pipe/simple{dir = 6; icon_state = "intact"; initialize_directions = 6; layer = 3; level = 2},/turf/simulated/floor,/area)
"ao" = (/obj/machinery/atmospherics/pipe/manifold{icon_state = "manifold"; level = 2},/turf/simulated/floor,/area)
"ap" = (/obj/machinery/atmospherics/pipe/simple{dir = 4; icon_state = "intact"; layer = 3; level = 2},/turf/simulated/floor,/area)
"aq" = (/obj/machinery/atmospherics/unary/generator_input{tag = "icon-intact (WEST)"; icon_state = "intact"; dir = 8},/turf/simulated/floor,/area)
"ar" = (/obj/machinery/power/generator_type2,/turf/simulated/floor,/area)
"as" = (/obj/machinery/atmospherics/unary/generator_input{tag = "icon-intact (EAST)"; icon_state = "intact"; dir = 4},/turf/simulated/floor,/area)
"at" = (/obj/machinery/atmospherics/pipe/manifold{dir = 1; icon_state = "manifold"; level = 2},/turf/simulated/floor,/area)
"au" = (/obj/machinery/atmospherics/pipe/simple{dir = 4; icon_state = "intact"; layer = 3; level = 2},/turf/simulated/wall/r_wall,/area)
"av" = (/obj/lattice,/obj/machinery/atmospherics/pipe/simple{dir = 10; icon_state = "intact"; initialize_directions = 10; layer = 3; level = 2},/turf/space,/area)
"aw" = (/obj/landmark/start{name = "Captain"},/turf/simulated/floor,/area)
"ax" = (/obj/machinery/atmospherics/pipe/simple{icon_state = "intact"; level = 2},/turf/simulated/floor,/area)
"ay" = (/obj/machinery/atmospherics/portables_connector{dir = 4},/turf/simulated/floor,/area)
"az" = (/obj/machinery/atmospherics/pipe/simple{dir = 4; icon_state = "intact"; layer = 3; level = 2},/obj/machinery/atmospherics/pipe/simple{icon_state = "intact"; level = 2},/turf/simulated/floor,/area)
"aA" = (/obj/machinery/atmospherics/pipe/simple{dir = 10; icon_state = "intact"; initialize_directions = 10; layer = 3; level = 2},/turf/simulated/floor,/area)
"aB" = (/obj/item/weapon/wrench,/turf/simulated/floor,/area)
"aC" = (/obj/lattice,/obj/machinery/atmospherics/pipe/manifold{dir = 8; icon_state = "manifold"; level = 2},/turf/space,/area)
"aD" = (/obj/lattice,/obj/machinery/atmospherics/unary/thermal_plate{tag = "icon-intact_off (WEST)"; icon_state = "intact_off"; dir = 8},/turf/space,/area)
"aE" = (/obj/window/reinforced/south,/turf/simulated/floor,/area)
"aF" = (/obj/window/reinforced/south,/obj/machinery/atmospherics/pipe/simple{icon_state = "intact"; level = 2},/turf/simulated/floor,/area)
"aG" = (/obj/window/reinforced/south,/obj/machinery/portable_atmospherics/canister/oxygen,/turf/simulated/floor,/area)
"aH" = (/obj/window/reinforced/south,/obj/item/weapon/wrench,/turf/simulated/floor,/area)
"aI" = (/obj/window/reinforced/south,/obj/machinery/atmospherics/unary/cold_sink/freezer,/turf/simulated/floor,/area)
"aJ" = (/obj/window/reinforced/east,/turf/simulated/wall,/area)
"aK" = (/turf/simulated/wall/heatshield,/area)
"aL" = (/obj/machinery/atmospherics/pipe/simple{icon_state = "intact"; level = 2},/turf/simulated/wall/heatshield,/area)
"aM" = (/obj/window/reinforced/west,/obj/window/reinforced/north,/obj/machinery/atmospherics/pipe/simple{icon_state = "intact"; level = 2},/turf/simulated/floor/engine/vacuum,/area)
"aN" = (/obj/window/reinforced/north,/turf/simulated/floor/engine/vacuum,/area)
"aO" = (/obj/window/reinforced/north,/obj/machinery/engine/laser{id = "north"},/turf/simulated/floor/engine/vacuum,/area)
"aP" = (/obj/window/reinforced/north,/obj/machinery/atmospherics/pipe/simple{icon_state = "intact"; level = 2},/turf/simulated/floor/engine/vacuum,/area)
"aQ" = (/obj/window/reinforced/west,/obj/machinery/atmospherics/pipe/simple{icon_state = "intact"; level = 2},/turf/simulated/floor/engine/vacuum,/area)
"aR" = (/turf/simulated/floor/engine/vacuum,/area)
"aS" = (/obj/machinery/atmospherics/pipe/vent{tag = "icon-intact (NORTH)"; icon_state = "intact"; dir = 1},/turf/simulated/floor/engine/vacuum,/area)
"aT" = (/obj/window/reinforced/west,/obj/machinery/atmospherics/pipe/simple{dir = 5; icon_state = "intact"; layer = 3; level = 2},/turf/simulated/floor/engine/vacuum,/area)
"aU" = (/obj/machinery/atmospherics/pipe/simple{dir = 4; icon_state = "intact"; layer = 3; level = 2},/turf/simulated/floor/engine/vacuum,/area)
"aV" = (/obj/machinery/atmospherics/unary/thermal_plate{tag = "icon-intact_off (WEST)"; icon_state = "intact_off"; dir = 8},/turf/simulated/floor/engine/vacuum,/area)
"aW" = (/obj/window/reinforced/west,/obj/machinery/engine/laser{dir = 4; icon_state = "laser"; id = "west"; tag = "icon-laser (EAST)"},/turf/simulated/floor/engine/vacuum,/area)
"aX" = (/obj/machinery/engine/supermatter,/turf/simulated/floor/engine/vacuum,/area)
"aY" = (/obj/machinery/engine/laser{dir = 8; icon_state = "laser"; id = "east"; tag = "icon-laser (WEST)"},/turf/simulated/floor/engine/vacuum,/area)
"aZ" = (/obj/lattice,/obj/machinery/atmospherics/unary/thermal_plate{tag = "icon-intact_off (NORTH)"; icon_state = "intact_off"; dir = 1},/turf/space,/area)
"ba" = (/obj/window/reinforced/west,/turf/simulated/floor/engine/vacuum,/area)
"bb" = (/obj/machinery/engine/laser{dir = 1; icon_state = "laser"; id = "south"; tag = "icon-laser (NORTH)"},/turf/simulated/floor/engine/vacuum,/area)

(1,1,1) = {"
aaaaaaaaaaaaaaaaaaaaaaaaaaaaaaaaaaaaaaaaaaaaaaaaaaaaaaaaaaaaaaaaaaaaaaaaaaaaaaaaaaaaaaaaaaaaaaaaaaaa
aaaaaaaaaaaaaaaaaaaaaaaaaaaaaaaaaaaaaaaaaaaaaaaaaaaaaaaaaaaaaaaaaaaaaaaaaaaaaaaaaaaaaaaaaaaaaaaaaaaa
aaaaaaaaaaaaaaaaaaaaaaaaaaaaaaaaaaaaaaaaaaaaaaaaaaaaaaaaaaaaaaaaaaaaaaaaaaaaaaaaaaaaaaaaaaaaaaaaaaaa
aaaaaaaaaaaaaaaaaaaaaaaaaaaaaaaaaaaaaaaaaaaaaaaaaaaaaaaaaaaaaaaaaaaaaaaaaaaaaaaaaaaaaaaaaaaaaaaaaaaa
aaaaaaaaaaaaaaaaaaaaaaaaaaaaaaaaaaaaaaaaaaaaaaaaaaaaaaaaaaaaaaaaaaaaaaaaaaaaaaaaaaaaaaaaaaaaaaaaaaaa
aaaaaaaaaaaaaaaaaaaaaaaaaaaaaaaaaaaaaaaaaaaaaaaaaaaaaaaaaaaaaaaaaaaaaaaaaaaaaaaaaaaaaaaaaaaaaaaaaaaa
aaaaaaaaaaaaaaaaaaaaaaaaaaaaaaaaaaaaaaaaaaaaaaaaaaaaaaaaaaaaaaaaaaaaaaaaaaaaaaaaaaaaaaaaaaaaaaaaaaaa
aaaaaaaaaaaaaaaaaaaaaaaaaaaaaaaaaaaaaaaaaaaaaaaaaaaaaaaaaaaaaaaaaaaaaaaaaaaaaaaaaaaaaaaaaaaaaaaaaaaa
aaaaaaaaaaaaaaaaaaaaaaaaaaaaaaaaaaaaaaaaaaaaaaaaaaaaaaaaaaaaaaaaaaaaaaaaaaaaaaaaaaaaaaaaaaaaaaaaaaaa
aaaaaaaaaaaaaaaaaaaaaaaaaaaaaaaaaaaaaaaaaaaaaaaaaaaaaaaaaaaaaaaaaaaaaaaaaaaaaaaaaaaaaaaaaaaaaaaaaaaa
aaaaaaaaaaaaaaaaaaaaaaaaaaaaaaaaaaaaaaaaaaaaaaaaaaaaaaaaaaaaaaaaaaaaaaaaaaaaaaaaaaaaaaaaaaaaaaaaaaaa
aaaaaaaaaaaaaaaaaaaaaaaaaaaaaaaaaaaaaaaaaaaaaaaaaaaaaaaaaaaaaaaaaaaaaaaaaaaaaaaaaaaaaaaaaaaaaaaaaaaa
aaaaaaaaaaaaaaaaaaaaaaaaaaaaaaaaaaaaaaaaaaaaaaaaaaaaaaaaaaaaaaaaaaaaaaaaaaaaaaaaaaaaaaaaaaaaaaaaaaaa
aaaaaaaaaaaaaaaaaaaaaaaaaaaaaaaaaaaaaaaaaaaaaaaaaaaaaaaaaaaaaaaaaaaaaaaaaaaaaaaaaaaaaaaaaaaaaaaaaaaa
aaaaaaaaaaaaaaaaaaaaaaaaaaaaaaaaaaaaaaaaaaaaaaaaaaaaaaaaaaaaaaaaaaaaaaaaaaaaaaaaaaaaaaaaaaaaaaaaaaaa
aaaaaaaaaaaaaaaaaaaaaaaaaaaaaaaaaaaaaaaaaaaaaaaaaaaaaaaaaaaaaaaaaaaaaaaaaaaaaaaaaaaaaaaaaaaaaaaaaaaa
aaaaaaaaaaaaaaaaaaaaaaaaaaaaaaaaaaaaaaaaaaaaaaaaaaaaaaaaaaaaaaaaaaaaaaaaaaaaaaaaaaaaaaaaaaaaaaaaaaaa
aaaaaaaaaaaaaaaaaaaaaaaaaaaaaaaaaaaaaaaaaaaaaaaaaaaaaaaaaaaaaaaaaaaaaaaaaaaaaaaaaaaaaaaaaaaaaaaaaaaa
aaaaaaaaaaaaaaaaaaaaaaaaaaaaaaaaaaaaaaaaaaaaaaaaaaaaaaaaaaaaaaaaaaaaaaaaaaaaaaaaaaaaaaaaaaaaaaaaaaaa
aaaaaaaaaaaaaaaaaaaaaaaaaaaaaaaaaaaaaaaaaaaaaaaaaaaaaaaaaaaaaaaaaaaaaaaaaaaaaaaaaaaaaaaaaaaaaaaaaaaa
aaaaaaaaaaaaaaaaaaaaaaaaaaaaaaaaaaaaaaaaaaaaaaaaaaaaaaaaaaaaaaaaaaaaaaaaaaaaaaaaaaaaaaaaaaaaaaaaaaaa
aaaaaaaaaaaaaaaaaaaaaaaaaaaaaaaaaaaaaaaaaaaaaaaaaaaaaaaaaaaaaaaaaaaaaaaaaaaaaaaaaaaaaaaaaaaaaaaaaaaa
aaaaaaaaaaaaaaaaaaaaaaaaaaaaaaaaaaaaaaaaaaaaaaaaaaaaaaaaaaaaaaaaaaaaaaaaaaaaaaaaaaaaaaaaaaaaaaaaaaaa
aaaaaaaaaaaaaaaaaaaaaaaaaaaaaaaaaaaaaaaaaaaaaaaaaaaaaaaaaaaaaaaaaaaaaaaaaaaaaaaaaaaaaaaaaaaaaaaaaaaa
aaaaaaaaaaaaaaaaaaaaaaaaaaaaaaaaaaaaaaaaaaaaaaaaaaaaaaaaaaaaaaaaaaaaaaaaaaaaaaaaaaaaaaaaaaaaaaaaaaaa
aaaaaaaaaaaaaaaaaaaaaaaaaaaaaaaaaaaaaaaaaaaaaaaaaaaaaaaaaaaaaaaaaaaaaaaaaaaaaaaaaaaaaaaaaaaaaaaaaaaa
aaaaaaaaaaaaaaaaaaaaaaaaaaaaaaaaaaaaaaaaaaaaaaaaaaaaaaaaaaaaaaaaaaaaaaaaaaaaaaaaaaaaaaaaaaaaaaaaaaaa
aaaaaaaaaaaaaaaaaaaaaaaaaaaaaaaaaaaaaaaaaaaaaaaaaaaaaaaaaaaaaaaaaaaaaaaaaaaaaaaaaaaaaaaaaaaaaaaaaaaa
aaaaaaaaaaaaaaaaaaaaaaaaaaaaaaaaaaaaaaaaaaaaaaaaaaaaaaaaaaaaaaaaaaaaaaaaaaaaaaaaaaaaaaaaaaaaaaaaaaaa
aaaaaaaaaaaaaaaaaaaaaaaaaaaaaaaaaaaaaaaaaaaaaaaaaaaaaaaaaaaaaaaaaaaaaaaaaaaaaaaaaaaaaaaaaaaaaaaaaaaa
aaaaaaaaaaaaaaaaaaaaaaaaaaaaaaaaaaaaaaaaaaaaaaaaaaaaaaaaaaaaaaaaaaaaaaaaaaaaaaaaaaaaaaaaaaaaaaaaaaaa
aaaaaaaaaaaaaaaaaaaaaaaaaaaaaaaaaaaaaaaaaaaaaaaaaaaaaaaaaaaaaaaaaaaaaaaaaaaaaaaaaaaaaaaaaaaaaaaaaaaa
aaaaaaaaaaaaaaaaaaaaaaaaaaaaaaaaaaaaaaaaaaaaaaaaaaaaaaaaaaaaaaaaaaaaaaaaaaaaaaaaaaaaaaaaaaaaaaaaaaaa
aaaaaaaaaaaaaaaaaaaaaaaaaaaaaaaaaaaaaaaaaaaaaaaaaaaaaaaaaaaaaaaaaaaaaaaaaaaaaaaaaaaaaaaaaaaaaaaaaaaa
ababababababababababababababababaaaaaaaaaaaaaaaaaaaaaaaaaaaaaaaaaaaaaaaaaaaaaaaaaaaaaaaaaaaaaaaaaaaa
abacadaeafagacacacacacacacacacahaiaiaaaaaaaaaaaaaaaaaaaaaaaaaaaaaaaaaaaaaaaaaaaaaaaaaaaaaaaaaaaaaaaa
abacajacajacacacacacakacacacacahaiaiaaaaaaaaaaaaaaaaaaaaaaaaaaaaaaaaaaaaaaaaaaaaaaaaaaaaaaaaaaaaaaaa
abacacalalacacacacacacacalalacahaiaiaaaaaaaaaaaaaaaaaaaaaaaaaaaaaaaaaaaaaaaaaaaaaaaaaaaaaaaaaaaaaaaa
abamanaoaoapapaqarasatapaoaoatauavaiaaaaaaaaaaaaaaaaaaaaaaaaaaaaaaaaaaaaaaaaaaaaaaaaaaaaaaaaaaaaaaaa
abawaxayapapapapapapazaAaBacaxahaCaDaaaaaaaaaaaaaaaaaaaaaaaaaaaaaaaaaaaaaaaaaaaaaaaaaaaaaaaaaaaaaaaa
abaEaFaGaHaEaEaEaEaEaIaFaEaEaIahaCaDaaaaaaaaaaaaaaaaaaaaaaaaaaaaaaaaaaaaaaaaaaaaaaaaaaaaaaaaaaaaaaaa
aJaKaLaKaKaKaKaKaKaKaKaLaKaKaKahaCaDaaaaaaaaaaaaaaaaaaaaaaaaaaaaaaaaaaaaaaaaaaaaaaaaaaaaaaaaaaaaaaaa
aJaKaMaNaNaNaNaNaOaNaNaPaNaNaNahaCaDaaaaaaaaaaaaaaaaaaaaaaaaaaaaaaaaaaaaaaaaaaaaaaaaaaaaaaaaaaaaaaaa
aJaKaQaRaRaRaRaRaRaRaRaSaRaRaRahaCaDaaaaaaaaaaaaaaaaaaaaaaaaaaaaaaaaaaaaaaaaaaaaaaaaaaaaaaaaaaaaaaaa
aJaKaTaUaUaUaUaUaVaRaRaRaRaRaRahaCaDaaaaaaaaaaaaaaaaaaaaaaaaaaaaaaaaaaaaaaaaaaaaaaaaaaaaaaaaaaaaaaaa
aJaKaWaRaRaRaRaRaXaRaRaRaRaRaYahaZaiaaaaaaaaaaaaaaaaaaaaaaaaaaaaaaaaaaaaaaaaaaaaaaaaaaaaaaaaaaaaaaaa
aJaKbaaRaRaRaRaRaRaRaRaRaRaRaRahaiaiaaaaaaaaaaaaaaaaaaaaaaaaaaaaaaaaaaaaaaaaaaaaaaaaaaaaaaaaaaaaaaaa
aJaKbaaRaRaRaRaRaRaRaRaRaRaRaRahaiaiaaaaaaaaaaaaaaaaaaaaaaaaaaaaaaaaaaaaaaaaaaaaaaaaaaaaaaaaaaaaaaaa
aJaKbaaRaRaRaRaRbbaRaRaRaRaRaRahaiaiaaaaaaaaaaaaaaaaaaaaaaaaaaaaaaaaaaaaaaaaaaaaaaaaaaaaaaaaaaaaaaaa
ahahahahahahahahahahahahahahahahaiaiaaaaaaaaaaaaaaaaaaaaaaaaaaaaaaaaaaaaaaaaaaaaaaaaaaaaaaaaaaaaaaaa
"}
