"aa" = (/turf/space,/area)
"ab" = (/obj/machinery/power/solar,/obj/cabling/power,/obj/cabling/power{icon_state = "0-2"},/obj/window/reinforced{tag = "icon-rwindow (EAST)"; icon_state = "rwindow"; dir = 4},/obj/cabling/power{icon_state = "0-2"},/turf/unsimulated/floor,/area/solar/fore)
"ac" = (/turf/space,/area/shuttle/escape/transit/pod2)
"ad" = (/obj/window/reinforced{tag = "icon-rwindow (NORTH)"; icon_state = "rwindow"; dir = 1},/obj/window/reinforced,/obj/window/reinforced{tag = "icon-rwindow (WEST)"; icon_state = "rwindow"; dir = 8},/obj/machinery/atmospherics/unary/outlet_injector{tag = "icon-on"; icon_state = "on"; dir = 2; initialize_directions = 8; on = 1},/turf/simulated/floor/plating,/area/atmos)
"ae" = (/obj/window/reinforced{tag = "icon-rwindow (NORTH)"; icon_state = "rwindow"; dir = 1},/obj/window/reinforced{tag = "icon-rwindow (EAST)"; icon_state = "rwindow"; dir = 4},/obj/machinery/atmospherics/unary/outlet_injector{dir = 4; icon_state = "on"; on = 1; volume_rate = 150},/turf/simulated/floor/plating,/area/atmos)
"af" = (/obj/window/reinforced{tag = "icon-rwindow (EAST)"; icon_state = "rwindow"; dir = 4},/obj/window/reinforced{tag = "icon-rwindow (NORTH)"; icon_state = "rwindow"; dir = 1},/obj/machinery/atmospherics/binary/pump{dir = 8; icon_state = "intact_on"; on = 1},/obj/cabling/power{icon_state = "2-4"},/obj/machinery/light/small{dir = 1},/obj/landmark/start{name = "Atmospheric Technician"},/turf/simulated/floor,/area/atmos)
"ag" = (/obj/window/reinforced{tag = "icon-rwindow (EAST)"; icon_state = "rwindow"; dir = 4},/obj/window/reinforced{tag = "icon-rwindow (NORTH)"; icon_state = "rwindow"; dir = 1},/obj/machinery/atmospherics/pipe/simple{dir = 4; icon_state = "intact"; layer = 3; level = 2},/obj/cabling/power{icon_state = "4-8"},/turf/simulated/floor,/area/hallway/primary/central)
"ah" = (/obj/machinery/disposal,/obj/disposalpipe/trunk{dir = 4},/obj/machinery/atmospherics/pipe/simple{dir = 4; icon_state = "intact"; layer = 3; level = 2},/obj/cabling/power{icon_state = "4-8"},/obj/window/reinforced{tag = "icon-rwindow (NORTH)"; icon_state = "rwindow"; dir = 1},/turf/simulated/floor,/area/crew_quarters/bar)
"ai" = (/obj/disposalpipe/segment{dir = 2; icon_state = "pipe-c"},/obj/cabling/power{icon_state = "2-4"},/obj/landmark/start{name = "Chef"},/obj/machinery/atmospherics/pipe/simple{dir = 4; icon_state = "intact"; layer = 3; level = 2},/obj/cabling/power{icon_state = "4-8"},/obj/window/reinforced{tag = "icon-rwindow (NORTH)"; icon_state = "rwindow"; dir = 1},/turf/simulated/floor,/area/crew_quarters/bar)
"aj" = (/obj/machinery/door/window/eastleft,/obj/cabling/power{icon_state = "4-8"},/obj/landmark/start{name = "Barman"},/obj/machinery/atmospherics/pipe/simple{dir = 4; icon_state = "intact"; layer = 3; level = 2},/obj/window/reinforced{tag = "icon-rwindow (NORTH)"; icon_state = "rwindow"; dir = 1},/turf/simulated/floor,/area/crew_quarters/bar)
"ak" = (/obj/window/reinforced{tag = "icon-rwindow (EAST)"; icon_state = "rwindow"; dir = 4},/obj/cabling/power{icon_state = "2-8"},/obj/window/reinforced{tag = "icon-rwindow (NORTH)"; icon_state = "rwindow"; dir = 1},/obj/machinery/atmospherics/pipe/simple{dir = 10; icon_state = "intact"; initialize_directions = 10; layer = 3; level = 1},/turf/simulated/floor/plating,/area/maintenance/maintcentral1)
"al" = (/obj/machinery/power/solar,/obj/cabling/power,/obj/window/reinforced,/obj/window/reinforced{tag = "icon-rwindow (EAST)"; icon_state = "rwindow"; dir = 4},/obj/cabling/power,/obj/cabling/power{icon_state = "0-2"},/turf/unsimulated/floor,/area/solar/fore)
"am" = (/obj/window/reinforced{tag = "icon-rwindow (EAST)"; icon_state = "rwindow"; dir = 4},/obj/window/reinforced{tag = "icon-rwindow (WEST)"; icon_state = "rwindow"; dir = 8},/obj/machinery/door/window/southleft,/obj/window/reinforced{tag = "icon-rwindow (NORTH)"; icon_state = "rwindow"; dir = 1},/obj/landmark{name = "JoinLate"},/turf/simulated/floor,/area/shuttle/escape/station/pod2)
"an" = (/obj/window/reinforced,/obj/window/reinforced{tag = "icon-rwindow (EAST)"; icon_state = "rwindow"; dir = 4},/obj/machinery/atmospherics/pipe/tank/air{tag = "icon-intact (NORTH)"; icon_state = "intact"; dir = 1},/obj/window/reinforced{tag = "icon-rwindow (WEST)"; icon_state = "rwindow"; dir = 8},/turf/simulated/floor/plating,/area/atmos)
"ao" = (/obj/window/reinforced{tag = "icon-rwindow (EAST)"; icon_state = "rwindow"; dir = 4},/obj/window/reinforced,/obj/machinery/atmospherics/unary/vent_pump{dir = 4; external_pressure_bound = 0; icon_state = "in"; initialize_directions = 1; internal_pressure_bound = 4000; on = 1; pressure_checks = 2; pump_direction = 0},/turf/simulated/floor/plating,/area/atmos)
"ap" = (/obj/machinery/atmospherics/binary/pump{dir = 4; icon_state = "intact_on"; on = 1},/obj/machinery/door/window/eastleft,/obj/cabling/power,/obj/machinery/power/apc{dir = 1; name = "North APC"; pixel_x = 0},/obj/disposalpipe/segment{dir = 4; icon_state = "pipe-c"},/obj/item/weapon/storage/toolbox/mechanical,/obj/item/weapon/sheet/glass{amount = 50},/obj/item/weapon/sheet/glass{amount = 50},/turf/simulated/floor,/area/atmos)
"aq" = (/obj/machinery/door/window/eastleft,/obj/machinery/atmospherics/pipe/manifold{dir = 1; icon_state = "manifold"; initialize_directions = 14; level = 2},/obj/machinery/alarm{pixel_y = 26; tag = "North"; vent_connected = "CafeVent"},/obj/disposalpipe/junction{dir = 4},/turf/simulated/floor,/area/hallway/primary/central)
"ar" = (/obj/disposalpipe/segment{dir = 4},/obj/machinery/atmospherics/unary/vent_filter{dir = 8},/turf/simulated/floor,/area/crew_quarters/bar)
"as" = (/obj/disposalpipe/junction,/obj/table,/obj/cabling/power,/obj/machinery/power/apc{dir = 1; name = "North APC"; pixel_x = 0},/turf/simulated/floor,/area/crew_quarters/bar)
"at" = (/obj/window/reinforced{tag = "icon-rwindow (EAST)"; icon_state = "rwindow"; dir = 4},/obj/secure_closet/bar,/obj/machinery/atmospherics/unary/vent_scrubber{dir = 4; icon_state = "on"; on = 1; scrub_Toxins = 1; tag = "icon-off (EAST)"},/obj/machinery/alarm{pixel_y = 26; tag = "North"; vent_connected = "CafeVent"},/turf/simulated/floor,/area/crew_quarters/bar)
"au" = (/obj/window/reinforced{tag = "icon-rwindow (EAST)"; icon_state = "rwindow"; dir = 4},/obj/cabling/power,/obj/machinery/power/apc{dir = 1; name = "North APC"; pixel_x = 0},/obj/cabling/power{icon_state = "0-2"},/obj/machinery/atmospherics/pipe/manifold{dir = 4; icon_state = "manifold"; initialize_directions = 11; level = 2},/turf/simulated/floor/plating,/area/maintenance/maintcentral1)
"av" = (/obj/window/reinforced{tag = "icon-rwindow (WEST)"; icon_state = "rwindow"; dir = 8},/obj/stool/bed,/obj/cabling/power{icon_state = "1-2"},/obj/landmark/start{name = "Unassigned"},/obj/machinery/light/small{dir = 8},/turf/simulated/floor,/area/crew_quarters/sleeping/A)
"aw" = (/obj/stool/bed,/obj/machinery/door/window/northleft,/obj/landmark/start{name = "Unassigned"},/turf/simulated/floor,/area/crew_quarters/sleeping/A)
"ax" = (/obj/stool/bed,/obj/landmark/start{name = "Counselor"},/turf/simulated/floor,/area/crew_quarters/sleeping/A)
"ay" = (/obj/window/reinforced{tag = "icon-rwindow (EAST)"; icon_state = "rwindow"; dir = 4},/obj/disposalpipe/trunk,/obj/machinery/disposal,/turf/simulated/floor,/area/crew_quarters/sleeping/A)
"az" = (/obj/window/reinforced,/obj/window/reinforced{tag = "icon-rwindow (EAST)"; icon_state = "rwindow"; dir = 4},/obj/disposalpipe/trunk{tag = "icon-pipe-t (NORTH)"; icon_state = "pipe-t"; dir = 1},/obj/machinery/disposal,/turf/simulated/floor,/area/atmos)
"aA" = (/obj/window/reinforced{tag = "icon-rwindow (EAST)"; icon_state = "rwindow"; dir = 4},/obj/machinery/atmospherics/pipe/simple{icon_state = "intact"; level = 2},/obj/machinery/light/small{dir = 4},/obj/disposalpipe/segment,/turf/simulated/floor,/area/hallway/primary/central)
"aB" = (/obj/window/reinforced{tag = "icon-rwindow (NORTH)"; icon_state = "rwindow"; dir = 1},/obj/secure_closet/hos,/turf/simulated/floor,/area/security/main)
"aC" = (/obj/window/reinforced{tag = "icon-rwindow (NORTH)"; icon_state = "rwindow"; dir = 1},/obj/landmark/start{name = "Head of Security"},/obj/disposalpipe/segment,/turf/simulated/floor,/area/security/main)
"aD" = (/obj/window/reinforced{tag = "icon-rwindow (EAST)"; icon_state = "rwindow"; dir = 4},/obj/window/reinforced{tag = "icon-rwindow (NORTH)"; icon_state = "rwindow"; dir = 1},/obj/secure_closet/security1,/turf/simulated/floor,/area/security/main)
"aE" = (/obj/window/reinforced{tag = "icon-rwindow (EAST)"; icon_state = "rwindow"; dir = 4},/obj/cabling/power{icon_state = "1-2"},/obj/machinery/light/small{dir = 4},/obj/machinery/atmospherics/pipe/simple{icon_state = "intact"; level = 2},/turf/simulated/floor/plating,/area/maintenance/maintcentral1)
"aF" = (/obj/window/reinforced{tag = "icon-rwindow (WEST)"; icon_state = "rwindow"; dir = 8},/obj/stool/bed,/obj/window/reinforced,/obj/cabling/power{icon_state = "1-2"},/obj/machinery/atmospherics/unary/vent_scrubber{dir = 2; icon_state = "on"; on = 1; scrub_Toxins = 1; tag = "icon-off (SOUTH)"},/obj/landmark/start{name = "Unassigned"},/turf/simulated/floor,/area/crew_quarters/sleeping/A)
"aG" = (/obj/stool/bed,/obj/window/reinforced,/obj/machinery/alarm{pixel_y = 26; tag = "North"; vent_connected = "CafeVent"},/obj/landmark/start{name = "Research Director"},/turf/simulated/floor,/area/crew_quarters/sleeping/A)
"aH" = (/obj/stool/bed,/obj/window/reinforced,/obj/machinery/power/apc{dir = 1; name = "North APC"; pixel_x = 0},/obj/cabling/power{icon_state = "0-4"},/obj/landmark/start{name = "Quartermaster"},/turf/simulated/floor,/area/crew_quarters/sleeping/A)
"aI" = (/obj/stool/bed,/obj/window/reinforced,/obj/machinery/door/window/eastleft,/obj/disposalpipe/segment{icon_state = "pipe-c"; dir = 1; pixel_y = 1},/obj/cabling/power{icon_state = "4-8"},/obj/landmark/start{name = "Janitor"},/obj/machinery/atmospherics/unary/vent_filter{dir = 4; initialize_directions = 4},/turf/simulated/floor,/area/crew_quarters/sleeping/A)
"aJ" = (/obj/cabling/power{icon_state = "4-8"},/obj/machinery/atmospherics/pipe/manifold{dir = 1; icon_state = "manifold"; initialize_directions = 14; level = 2},/obj/disposalpipe/segment{dir = 4},/turf/simulated/floor,/area/hallway/primary/central)
"aK" = (/obj/machinery/door/window/eastleft,/obj/machinery/atmospherics/pipe/manifold{icon_state = "manifold"; level = 2},/obj/cabling/power{icon_state = "4-8"},/obj/disposalpipe/segment{dir = 8; icon_state = "pipe-c"},/turf/simulated/floor,/area/hallway/primary/central)
"aL" = (/obj/landmark/start{name = "Security Officer"},/obj/machinery/atmospherics/unary/vent_filter{dir = 8},/obj/machinery/power/apc{cell_type = 1000; dir = 4; name = "East APC"; pixel_x = 0},/obj/cabling/power{icon_state = "0-4"},/obj/cabling/power{icon_state = "0-8"},/turf/simulated/floor,/area/security/main)
"aM" = (/obj/window/reinforced,/obj/landmark/start{name = "Detective"},/obj/disposalpipe/segment,/obj/machinery/alarm{pixel_y = 26; tag = "North"; vent_connected = "CafeVent"},/obj/cabling/power{icon_state = "2-8"},/turf/simulated/floor,/area/security/main)
"aN" = (/obj/window/reinforced,/obj/window/reinforced{tag = "icon-rwindow (EAST)"; icon_state = "rwindow"; dir = 4},/obj/table,/obj/machinery/atmospherics/unary/vent_scrubber{dir = 4; icon_state = "on"; on = 1; scrub_Toxins = 1; tag = "icon-off (EAST)"},/obj/item/weapon/storage/handcuff_kit,/turf/simulated/floor,/area/security/main)
"aO" = (/obj/window/reinforced{tag = "icon-rwindow (EAST)"; icon_state = "rwindow"; dir = 4},/obj/cabling/power{icon_state = "1-2"},/obj/machinery/atmospherics/pipe/manifold{dir = 4; icon_state = "manifold"; initialize_directions = 11; level = 2},/turf/simulated/floor/plating,/area/maintenance/maintcentral1)
"aP" = (/obj/window/reinforced{tag = "icon-rwindow (WEST)"; icon_state = "rwindow"; dir = 8},/obj/machinery/dna_scannernew,/obj/cabling/power{icon_state = "1-2"},/obj/machinery/atmospherics/pipe/simple{icon_state = "intact"; level = 2},/turf/simulated/floor{icon_state = "white"},/area/chemistry)
"aQ" = (/obj/machinery/computer/cloning,/obj/machinery/atmospherics/pipe/simple{dir = 6; icon_state = "intact"; initialize_directions = 6; layer = 3; level = 1},/turf/simulated/floor{icon_state = "white"},/area/chemistry)
"aR" = (/obj/machinery/chem_dispenser,/obj/machinery/atmospherics/pipe/simple{dir = 4; icon_state = "intact"; layer = 3; level = 2},/turf/simulated/floor{icon_state = "white"},/area/chemistry)
"aS" = (/obj/window/reinforced{tag = "icon-rwindow (EAST)"; icon_state = "rwindow"; dir = 4},/obj/machinery/chem_master,/obj/machinery/atmospherics/pipe/simple{dir = 10; icon_state = "intact"; initialize_directions = 10; layer = 3; level = 2},/turf/simulated/floor{icon_state = "white"},/area/chemistry)
"aT" = (/obj/window/reinforced{tag = "icon-rwindow (EAST)"; icon_state = "rwindow"; dir = 4},/obj/machinery/atmospherics/pipe/manifold{dir = 8; icon_state = "manifold"; level = 2},/obj/machinery/light/small{dir = 8},/turf/simulated/floor,/area/hallway/primary/central)
"aU" = (/obj/machinery/door/window/northleft,/obj/landmark/start{name = "Security Officer"},/obj/machinery/atmospherics/unary/vent_filter{dir = 8},/turf/simulated/floor,/area/security/brig)
"aV" = (/obj/window/reinforced{tag = "icon-rwindow (EAST)"; icon_state = "rwindow"; dir = 4},/obj/machinery/door/window/northleft,/obj/landmark/start{name = "Security Officer"},/obj/machinery/power/apc{dir = 8; name = "West APC"; pixel_x = 0},/obj/cabling/power{icon_state = "0-4"},/obj/machinery/light/small{dir = 4},/obj/machinery/atmospherics/unary/vent_scrubber{dir = 4; icon_state = "on"; on = 1; scrub_Toxins = 1; tag = "icon-off (EAST)"},/obj/machinery/alarm{dir = 1; icon_state = "alarm0"; pixel_y = -22; tag = "south"; vent_connected = "QMStorageVent"},/turf/simulated/floor,/area/security/brig)
"aW" = (/obj/cabling/power{icon_state = "1-2"},/obj/cabling/power{icon_state = "2-8"},/obj/cabling/power{icon_state = "2-4"},/obj/disposalpipe/segment,/obj/machinery/atmospherics/pipe/manifold{dir = 1; icon_state = "manifold"; level = 2},/turf/simulated/floor/plating,/area/maintenance/maintcentral1)
"aX" = (/obj/window/reinforced,/obj/cabling/power{icon_state = "4-8"},/obj/machinery/atmospherics/pipe/simple{dir = 4; icon_state = "intact"; layer = 3; level = 2},/turf/simulated/floor/plating,/area/maintenance/maintcentral1)
"aY" = (/obj/window/reinforced,/obj/window/reinforced{tag = "icon-rwindow (EAST)"; icon_state = "rwindow"; dir = 4},/obj/cabling/power{icon_state = "1-8"},/obj/machinery/atmospherics/pipe/simple{dir = 9; icon_state = "intact"; layer = 3; level = 2},/turf/simulated/floor/plating,/area/maintenance/maintcentral1)
"aZ" = (/obj/window/reinforced{tag = "icon-rwindow (WEST)"; icon_state = "rwindow"; dir = 8},/obj/cabling/power{icon_state = "1-2"},/obj/machinery/atmospherics/pipe/manifold{dir = 8; icon_state = "manifold"; level = 2},/obj/landmark/start{name = "Scientist"},/obj/machinery/light/small{dir = 8},/turf/simulated/floor{icon_state = "white"},/area/chemistry)
"ba" = (/obj/machinery/alarm{dir = 4; icon_state = "alarm0"; layer = 3.1; pixel_x = -22; tag = "west"; vent_connected = "QMStorageVent"},/obj/cabling/power{icon_state = "2-4"},/obj/machinery/atmospherics/pipe/simple{dir = 4; icon_state = "intact"; layer = 3; level = 2},/obj/machinery/atmospherics/pipe/simple{icon_state = "intact"; level = 2},/obj/landmark/start{name = "Research Director"},/turf/simulated/floor{icon_state = "white"},/area/chemistry)
"bb" = (/obj/cabling/power{icon_state = "0-8"},/obj/machinery/power/apc{dir = 8; name = "West APC"; pixel_x = 0},/obj/machinery/atmospherics/unary/vent_scrubber{dir = 8; icon_state = "on"; on = 1; scrub_Toxins = 1; tag = "icon-off (SOUTH)"},/obj/landmark/start{name = "Geneticist"},/turf/simulated/floor{icon_state = "white"},/area/chemistry)
"bc" = (/obj/machinery/atmospherics/pipe/manifold{dir = 8; icon_state = "manifold"; level = 2},/obj/landmark/start{name = "Chemist"},/obj/machinery/door/window/eastleft,/turf/simulated/floor{icon_state = "white"},/area/chemistry)
"bd" = (/obj/window/reinforced{tag = "icon-rwindow (EAST)"; icon_state = "rwindow"; dir = 4},/obj/machinery/atmospherics/pipe/manifold{dir = 4; icon_state = "manifold"; initialize_directions = 11; level = 2},/turf/simulated/floor,/area/hallway/primary/central)
"be" = (/obj/window/reinforced,/obj/window/reinforced{tag = "icon-rwindow (EAST)"; icon_state = "rwindow"; dir = 4},/obj/window/reinforced{tag = "icon-rwindow (WEST)"; icon_state = "rwindow"; dir = 8},/obj/machinery/door/window/northleft,/obj/landmark/start,/turf/simulated/floor,/area/security/brig)
"bf" = (/obj/window/reinforced{tag = "icon-rwindow (EAST)"; icon_state = "rwindow"; dir = 4},/obj/secure_closet/brig,/turf/simulated/floor,/area/security/brig)
"bg" = (/obj/window/reinforced{tag = "icon-rwindow (EAST)"; icon_state = "rwindow"; dir = 4},/obj/cabling/power{icon_state = "1-4"},/obj/cabling/power{icon_state = "2-4"},/obj/disposalpipe/segment,/obj/machinery/atmospherics/pipe/manifold{dir = 8; icon_state = "manifold"; initialize_directions = 7; level = 2},/obj/machinery/alarm{pixel_y = 26; tag = "North"; vent_connected = "CafeVent"},/turf/simulated/floor/plating,/area/maintenance/maintcentral1)
"bh" = (/obj/cabling/power{icon_state = "0-4"},/obj/cabling/power{icon_state = "0-8"},/obj/machinery/power/apc{cell_type = 1000; dir = 4; name = "East APC"; pixel_x = 0},/obj/landmark/start{name = "Chief Engineer"},/obj/machinery/light/small{dir = 8},/obj/machinery/atmospherics/unary/vent_scrubber{dir = 8; icon_state = "on"; on = 1; scrub_Toxins = 1; tag = "icon-off (WEST)"},/turf/simulated/floor/plating,/area/engine/engine_smes)
"bi" = (/obj/machinery/power/smes,/obj/cabling/power{icon_state = "0-8"},/obj/window/reinforced{tag = "icon-rwindow (EAST)"; icon_state = "rwindow"; dir = 4},/turf/simulated/floor/plating,/area/engine/engine_smes)
"bj" = (/obj/window/reinforced,/obj/window/reinforced{tag = "icon-rwindow (WEST)"; icon_state = "rwindow"; dir = 8},/obj/machinery/dna_scannernew,/obj/cabling/power{icon_state = "1-2"},/obj/machinery/atmospherics/pipe/simple{icon_state = "intact"; level = 2},/turf/simulated/floor{icon_state = "white"},/area/chemistry)
"bk" = (/obj/window/reinforced,/obj/machinery/scan_consolenew,/obj/cabling/power{icon_state = "1-4"},/obj/machinery/atmospherics/pipe/simple{icon_state = "intact"; level = 2},/turf/simulated/floor{icon_state = "white"},/area/chemistry)
"bl" = (/obj/window/reinforced,/obj/machinery/clonepod,/turf/simulated/floor{icon_state = "white"},/area/chemistry)
"bm" = (/obj/window/reinforced{tag = "icon-rwindow (EAST)"; icon_state = "rwindow"; dir = 4},/obj/window/reinforced,/obj/table,/obj/machinery/atmospherics/unary/vent_filter{dir = 1; initialize_directions = 1},/turf/simulated/floor{icon_state = "white"},/area/chemistry)
"bn" = (/obj/machinery/door/window/eastleft,/obj/machinery/atmospherics/pipe/manifold{dir = 8; icon_state = "manifold"; level = 2},/turf/simulated/floor,/area/hallway/primary/central)
"bo" = (/obj/window/reinforced{tag = "icon-rwindow (NORTH)"; icon_state = "rwindow"; dir = 1},/obj/landmark/start{name = "Medical Doctor"},/obj/machinery/power/apc{dir = 4; name = "East APC"; pixel_x = 0},/obj/cabling/power{icon_state = "0-4"},/obj/machinery/atmospherics/pipe/manifold{dir = 1; icon_state = "manifold"; level = 2},/turf/simulated/floor,/area/medical/medbay)
"bp" = (/obj/window/reinforced{tag = "icon-rwindow (EAST)"; icon_state = "rwindow"; dir = 4},/obj/window/reinforced{tag = "icon-rwindow (NORTH)"; icon_state = "rwindow"; dir = 1},/obj/table,/obj/cabling/power{icon_state = "4-8"},/obj/machinery/atmospherics/pipe/simple{dir = 4; icon_state = "intact"; layer = 3; level = 2},/obj/cabling/power{icon_state = "2-4"},/obj/item/weapon/storage/firstaid/regular,/obj/item/weapon/storage/firstaid/fire,/obj/item/weapon/storage/firstaid/toxin,/turf/simulated/floor,/area/medical/medbay)
"bq" = (/obj/machinery/door/window/eastleft,/obj/cabling/power{icon_state = "1-8"},/obj/disposalpipe/segment,/obj/machinery/atmospherics/pipe/simple{dir = 4; icon_state = "intact"; layer = 3; level = 2},/obj/machinery/atmospherics/pipe/simple{icon_state = "intact"; level = 2},/turf/simulated/floor/plating,/area/maintenance/maintcentral1)
"br" = (/obj/landmark/start{name = "Engineer"},/obj/machinery/atmospherics/unary/vent_filter{dir = 8},/obj/machinery/alarm{pixel_y = 26; tag = "North"; vent_connected = "CafeVent"},/obj/item/weapon/storage/toolbox/electrical,/obj/item/weapon/storage/lightbox,/obj/item/weapon/sheet/metal{amount = 50},/obj/item/weapon/sheet/metal{amount = 50},/turf/simulated/floor/plating,/area/engine/engine_smes)
"bs" = (/obj/machinery/power/terminal{tag = "icon-term (NORTH)"; icon_state = "term"; dir = 1},/obj/cabling/power{icon_state = "0-2"},/obj/landmark/start{name = "Engineer"},/obj/window/reinforced{tag = "icon-rwindow (EAST)"; icon_state = "rwindow"; dir = 4},/turf/simulated/floor/plating,/area/engine/engine_smes)
"bt" = (/obj/window/reinforced{tag = "icon-rwindow (WEST)"; icon_state = "rwindow"; dir = 8},/obj/window/reinforced{tag = "icon-rwindow (EAST)"; icon_state = "rwindow"; dir = 4},/obj/secure_closet/captains,/obj/cabling/power{icon_state = "1-4"},/obj/machinery/atmospherics/pipe/simple{icon_state = "intact"; level = 2},/turf/simulated/floor,/area/crew_quarters/captain)
"bu" = (/obj/cabling/power{icon_state = "4-8"},/obj/cabling/power{icon_state = "1-2"},/obj/machinery/atmospherics/pipe/simple{dir = 5; icon_state = "intact"; layer = 3; level = 2},/obj/machinery/computer/card,/turf/simulated/floor,/area/hallway/primary/admin)
"bv" = (/obj/cabling/power{icon_state = "4-8"},/obj/machinery/atmospherics/unary/vent_filter{dir = 8},/obj/landmark/start{name = "Head of Personnel"},/turf/simulated/floor,/area/hallway/primary/admin)
"bw" = (/obj/window/reinforced,/obj/window/reinforced{tag = "icon-rwindow (EAST)"; icon_state = "rwindow"; dir = 4},/obj/cabling/power{icon_state = "4-8"},/obj/machinery/computer/communications,/turf/simulated/floor,/area/hallway/primary/admin)
"bx" = (/obj/window/reinforced{tag = "icon-rwindow (EAST)"; icon_state = "rwindow"; dir = 4},/obj/machinery/light/small{dir = 4},/obj/machinery/atmospherics/unary/vent_filter{dir = 1; initialize_directions = 1},/obj/cabling/power{icon_state = "2-8"},/turf/simulated/floor,/area/hallway/primary/central)
"by" = (/obj/landmark/start{name = "Medical Doctor"},/obj/machinery/atmospherics/unary/vent_filter{dir = 1; initialize_directions = 1},/turf/simulated/floor,/area/medical/medbay)
"bz" = (/obj/window/reinforced{tag = "icon-rwindow (EAST)"; icon_state = "rwindow"; dir = 4},/obj/stool/bed,/obj/machinery/light/small{dir = 4},/obj/machinery/atmospherics/unary/vent_scrubber{dir = 4; icon_state = "on"; on = 1; scrub_Toxins = 1; tag = "icon-off (EAST)"},/obj/machinery/alarm{pixel_y = 26; tag = "North"; vent_connected = "CafeVent"},/obj/cabling/power{icon_state = "1-2"},/turf/simulated/floor,/area/medical/medbay)
"bA" = (/obj/window/reinforced{tag = "icon-rwindow (EAST)"; icon_state = "rwindow"; dir = 4},/obj/disposalpipe/segment,/obj/machinery/atmospherics/pipe/manifold{dir = 4; icon_state = "manifold"; initialize_directions = 11; level = 2},/obj/cabling/power{icon_state = "2-4"},/turf/simulated/floor/plating,/area/maintenance/maintcentral1)
"bB" = (/obj/machinery/door/window/northleft,/obj/machinery/door/window/southleft,/obj/cabling/power{icon_state = "4-8"},/turf/simulated/floor/plating,/area/engine/engine_smes)
"bC" = (/obj/machinery/power/solar_control,/obj/window/reinforced,/obj/window/reinforced{tag = "icon-rwindow (EAST)"; icon_state = "rwindow"; dir = 4},/obj/window/reinforced{tag = "icon-rwindow (WEST)"; icon_state = "rwindow"; dir = 8},/obj/cabling/power,/obj/cabling/power{icon_state = "0-2"},/obj/cabling/power{icon_state = "0-8"},/turf/simulated/floor/plating,/area/engine/engine_smes)
"bD" = (/obj/window/reinforced,/obj/window/reinforced{tag = "icon-rwindow (WEST)"; icon_state = "rwindow"; dir = 8},/obj/machinery/door/window/eastleft,/obj/landmark/start{name = "Captain"},/obj/stool/bed,/obj/machinery/atmospherics/pipe/manifold{dir = 8; icon_state = "manifold"; level = 2},/turf/simulated/floor,/area/crew_quarters/captain)
"bE" = (/obj/machinery/door/window/southleft,/obj/cabling/power{icon_state = "2-4"},/obj/cabling/power{icon_state = "1-4"},/obj/machinery/atmospherics/unary/vent_scrubber{dir = 8; icon_state = "on"; on = 1; scrub_Toxins = 1; tag = "icon-off (SOUTH)"},/turf/simulated/floor,/area/hallway/primary/admin)
"bF" = (/obj/window/reinforced,/obj/machinery/door/window/eastleft,/obj/machinery/power/apc{dir = 1; name = "North APC"; pixel_x = 0},/obj/cabling/power{icon_state = "0-4"},/obj/cabling/power{icon_state = "0-8"},/obj/machinery/alarm{pixel_y = 26; tag = "North"; vent_connected = "CafeVent"},/turf/simulated/floor,/area/hallway/primary/admin)
"bG" = (/obj/machinery/door/window/southleft,/obj/cabling/power{icon_state = "0-2"},/obj/machinery/power/apc{cell_type = 1000; dir = 4; name = "East APC"; pixel_x = 0},/obj/machinery/atmospherics/unary/vent_scrubber{dir = 2; icon_state = "on"; on = 1; scrub_Toxins = 1; tag = "icon-off (SOUTH)"},/obj/cabling/power{icon_state = "4-8"},/turf/simulated/floor,/area/hallway/primary/central)
"bH" = (/obj/window/reinforced{tag = "icon-rwindow (EAST)"; icon_state = "rwindow"; dir = 4},/obj/window/reinforced,/obj/cabling/power{icon_state = "4-8"},/obj/cabling/power{icon_state = "1-2"},/turf/simulated/floor,/area/hallway/primary/central)
"bI" = (/obj/window/reinforced,/obj/machinery/sleeper,/obj/cabling/power{icon_state = "4-8"},/turf/simulated/floor,/area/medical/medbay)
"bJ" = (/obj/window/reinforced,/obj/window/reinforced{tag = "icon-rwindow (EAST)"; icon_state = "rwindow"; dir = 4},/obj/machinery/sleep_console,/obj/machinery/atmospherics/pipe/simple{dir = 6; icon_state = "intact"; initialize_directions = 6; layer = 3; level = 2},/obj/cabling/power{icon_state = "1-8"},/turf/simulated/floor,/area/medical/medbay)
"bK" = (/obj/window/reinforced{tag = "icon-rwindow (EAST)"; icon_state = "rwindow"; dir = 4},/obj/disposalpipe/segment,/obj/machinery/atmospherics/pipe/manifold{dir = 4; icon_state = "manifold"; initialize_directions = 11; level = 2},/obj/cabling/power{icon_state = "1-2"},/turf/simulated/floor/plating,/area/maintenance/maintcentral1)
"bL" = (/turf/space,/area/shuttle/escape/centcom/pod2)
"bM" = (/obj/machinery/power/solar,/obj/cabling/power,/obj/cabling/power{icon_state = "0-2"},/turf/unsimulated/floor,/area/solar/fore)
"bN" = (/obj/landmark/start{name = "AI"},/obj/window/reinforced,/obj/window/reinforced{tag = "icon-rwindow (WEST)"; icon_state = "rwindow"; dir = 8},/obj/machinery/atmospherics/pipe/simple{dir = 5; icon_state = "intact"; layer = 3; level = 1},/turf/simulated/floor/grid,/area/turret_protected/ai)
"bO" = (/obj/window/reinforced{tag = "icon-rwindow (EAST)"; icon_state = "rwindow"; dir = 4},/obj/window/reinforced,/obj/machinery/power/apc{dir = 8; name = "West APC"; pixel_x = 0},/obj/machinery/computer/aiupload,/obj/machinery/light/small,/obj/cabling/power,/obj/machinery/atmospherics/pipe/simple{dir = 4; icon_state = "intact"; layer = 3; level = 2},/turf/simulated/floor/grid,/area/turret_protected/ai)
"bP" = (/obj/window/reinforced,/obj/machinery/disposal,/obj/disposalpipe/trunk{dir = 4},/obj/machinery/atmospherics/pipe/simple{dir = 4; icon_state = "intact"; layer = 3; level = 2},/turf/simulated/floor/plating,/area/maintenance/maintcentral1)
"bQ" = (/obj/window/reinforced,/obj/disposalpipe/segment{dir = 4},/obj/machinery/atmospherics/pipe/manifold{icon_state = "manifold"; level = 2},/turf/simulated/floor/plating,/area/maintenance/maintcentral1)
"bR" = (/obj/window/reinforced,/obj/disposalpipe/segment{dir = 4},/obj/machinery/atmospherics/pipe/simple{dir = 4; icon_state = "intact"; layer = 3; level = 2},/obj/cabling/power{icon_state = "1-4"},/turf/simulated/floor/plating,/area/maintenance/maintcentral1)
"bS" = (/obj/window/reinforced,/obj/cabling/power{icon_state = "4-8"},/obj/disposalpipe/segment{dir = 4},/obj/machinery/atmospherics/pipe/simple{dir = 4; icon_state = "intact"; layer = 3; level = 2},/turf/simulated/floor/plating,/area/maintenance/maintcentral1)
"bT" = (/obj/window/reinforced,/obj/cabling/power{icon_state = "4-8"},/obj/machinery/light/small,/obj/disposalpipe/segment{dir = 4},/obj/machinery/atmospherics/pipe/simple{dir = 9; icon_state = "intact"; layer = 3; level = 2},/turf/simulated/floor/plating,/area/maintenance/maintcentral1)
"bU" = (/obj/window/reinforced,/obj/window/reinforced{tag = "icon-rwindow (EAST)"; icon_state = "rwindow"; dir = 4},/obj/disposalpipe/junction{dir = 4; icon_state = "pipe-j2"},/obj/machinery/atmospherics/unary/vent_scrubber{dir = 1; icon_state = "on"; on = 1; scrub_Toxins = 1},/obj/cabling/power{icon_state = "1-8"},/turf/simulated/floor/plating,/area/maintenance/maintcentral1)
"bV" = (/obj/disposaloutlet{tag = "icon-outlet (NORTH)"; icon_state = "outlet"; dir = 1},/obj/disposalpipe/trunk{dir = 8},/turf/space,/area)
"bW" = (/obj/machinery/power/solar,/obj/cabling/power,/turf/unsimulated/floor,/area/solar/fore)
"bX" = (/obj/mapinfo{decks = 1; mapname = "yocto-station"; name = "Yocto-station 10x10x1"},/turf/space,/area)

(1,1,1) = {"
aaaaaaaaaaaaaaaaaaaaaaaaaaaa
aaaaaaaaaaaaaaaaaaaaaaaaaaaa
aaaaabacadaeafagahaiajakaaaa
aaaaalamanaoapaqarasatauaaaa
aaaaavawaxayazaAaBaCaDaEaaaa
aaaaaFaGaHaIaJaKaLaMaNaOaaaa
aaaaaPaQaRaSaTaUaVaWaXaYaaaa
aaaaaZbabbbcbdbebfbgbhbiaaaa
aaaabjbkblbmbnbobpbqbrbsaaaa
aaaabtbubvbwbxbybzbAbBbCaaaa
aaaabDbEbFbGbHbIbJbKbLbMaaaa
aaaabNbObPbQbRbSbTbUbVbWaaaa
aaaaaaaaaaaaaaaaaaaaaaaaaaaa
bXaaaaaaaaaaaaaaaaaaaaaaaaaa
"}
