"a" = (/turf/simulated/floor/asteroid,/area/space)
"b" = (/obj/effect/decal/cleanable/greenglow,/obj/structure/inflatable/wall,/turf/simulated/floor/asteroid,/area/space)
"c" = (/obj/structure/inflatable/wall,/turf/simulated/floor/asteroid,/area/space)
"d" = (/obj/structure/table/standard,/obj/item/tank/oxygen,/obj/item/storage/fancy/cigarettes/luckystars,/turf/simulated/floor/plating,/area/space)
"e" = (/obj/item/stack/medical/advanced/ointment,/obj/item/stack/medical/advanced/ointment,/obj/item/stack/medical/advanced/ointment,/turf/simulated/floor/plating,/area/space)
"g" = (/turf/simulated/mineral,/area/space)
"h" = (/obj/machinery/portable_atmospherics/powered/pump/filled,/turf/simulated/floor/plating,/area/space)
"p" = (/obj/structure/inflatable/door,/turf/simulated/floor/plating,/area/space)
"q" = (/obj/item/storage/backpack/dufflebag/emt,/obj/item/stack/medical/bruise_pack,/obj/item/stack/medical/bruise_pack,/obj/item/stack/medical/splint,/obj/item/stack/medical/splint,/obj/item/reagent_containers/ivbag/nanoblood,/obj/item/reagent_containers/ivbag/nanoblood,/obj/item/reagent_containers/syringe,/turf/simulated/floor/plating,/area/space)
"r" = (/obj/item/stack/medical/advanced/ointment,/turf/simulated/floor/plating,/area/space)
"s" = (/obj/structure/bed/chair/red,/obj/item/trash/liquidfood,/turf/simulated/floor/plating,/area/space)
"v" = (/obj/item/storage/toolbox/mechanical,/turf/simulated/floor/asteroid,/area/space)
"y" = (/obj/effect/decal/cleanable/generic,/turf/simulated/floor/plating,/area/space)
"B" = (/obj/structure/table/standard,/obj/item/clothing/suit/space/void/mining/prepared,/turf/simulated/floor/plating,/area/space)
"F" = (/obj/item/stack/medical/advanced/bruise_pack,/obj/item/stack/medical/advanced/bruise_pack,/obj/item/stack/medical/advanced/bruise_pack,/obj/item/stack/medical/advanced/bruise_pack,/obj/effect/decal/cleanable/cobweb2,/turf/simulated/floor/plating,/area/space)
"G" = (/obj/effect/decal/cleanable/greenglow,/turf/simulated/floor/asteroid,/area/space)
"H" = (/obj/structure/ore_box,/turf/simulated/floor/asteroid,/area/space)
"K" = (/obj/structure/table/standard,/turf/simulated/floor/asteroid,/area/space)
"L" = (/turf/simulated/floor/plating,/area/space)
"N" = (/obj/structure/bed/chair/red,/turf/simulated/floor/plating,/area/space)
"R" = (/obj/item/storage/ore,/turf/simulated/floor/asteroid,/area/space)
"S" = (/obj/item/pickaxe/drill/adv,/turf/simulated/floor/asteroid,/area/space)
"T" = (/obj/structure/table/standard,/obj/item/cell/high,/obj/item/cell/high{layer = 4; pixel_x = 5; pixel_y = 9},/turf/simulated/floor/asteroid,/area/space)
"X" = (/obj/effect/decal/mecha_wreckage/ripley,/turf/simulated/floor/asteroid,/area/space)
"Z" = (/obj/machinery/portable_atmospherics/canister/oxygen,/turf/simulated/floor/asteroid,/area/space)

(1,1,1) = {"
aagbcggggg
aacsNeFcgg
aapLyLqggg
aacBdhrcgg
aaccgcccgg
aaaHgggggg
RaSagggggg
aaaaaaaXgg
aaavaaGggg
aZZKTggggg
"}
