"a" = (/turf/simulated/wall/r_wall,/area/engineering)
"b" = (/obj/effect/landmark/start/crew/ai,/obj/machinery/camera,/turf/simulated/floor/tiled/rough,/area/engineering)
"c" = (/turf/simulated/floor/tiled/rough,/area/engineering)
"d" = (/obj/machinery/light/spot{dir = 1},/turf/simulated/floor/tiled/rough,/area/engineering)
"e" = (/obj/machinery/camera{dir = 1},/turf/simulated/floor/tiled/rough,/area/engineering)
"f" = (/obj/effect/floor_decal/industrial/hatch/yellow,/turf/simulated/floor/tiled/rough,/area/engineering)
"g" = (/turf/simulated/wall,/area/engineering)
"h" = (/obj/machinery/light_switch{on = 1; pixel_x = 25},/turf/simulated/floor/tiled/rough,/area/engineering)
"i" = (/obj/machinery/light/spot{dir = 8},/turf/simulated/floor/tiled/rough,/area/engineering)
"j" = (/obj/structure/ladder/up,/turf/simulated/floor/tiled/rough,/area/engineering)
"k" = (/obj/machinery/light/spot{dir = 4},/turf/simulated/floor/tiled/rough,/area/engineering)
"l" = (/obj/effect/landmark/start/crew,/turf/simulated/floor/tiled/rough,/area/engineering)
"m" = (/obj/machinery/atmospherics/unary/vent_pump/on,/turf/simulated/floor/tiled/rough,/area/engineering)
"n" = (/obj/machinery/atmospherics/pipe/simple/visible{dir = 5},/turf/simulated/floor/tiled/rough,/area/engineering)
"o" = (/obj/machinery/atmospherics/pipe/simple/visible{dir = 4},/turf/simulated/floor/tiled/rough,/area/engineering)
"p" = (/obj/machinery/atmospherics/portables_connector{dir = 8},/obj/machinery/portable_atmospherics/canister/air,/turf/simulated/floor/tiled/rough,/area/engineering)
"q" = (/obj/machinery/light_switch{on = 1; pixel_x = -25},/obj/machinery/camera{dir = 4},/turf/simulated/floor/tiled/rough,/area/engineering)
"r" = (/obj/effect/landmark/start/crew/captain,/turf/simulated/floor/tiled/rough,/area/engineering)
"s" = (/obj/machinery/atmospherics/pipe/simple/visible{dir = 6},/turf/simulated/floor/tiled/rough,/area/engineering)
"t" = (/obj/machinery/atmospherics/portables_connector{dir = 8},/obj/machinery/portable_atmospherics/canister/empty,/turf/simulated/floor/tiled/rough,/area/engineering)
"u" = (/obj/machinery/door/airlock/external/bolted{frequency = 1379; id_tag = "lower_level_dock_hatch"},/turf/simulated/floor,/area/engineering)
"v" = (/obj/machinery/embedded_controller/radio/simple_docking_controller{id_tag = "lower_level_dock"; pixel_x = -8; pixel_y = -25},/obj/machinery/camera{dir = 1},/turf/simulated/floor,/area/engineering)
"w" = (/turf/simulated/floor,/area/engineering)
"x" = (/obj/machinery/atmospherics/unary/vent_scrubber/on{dir = 1},/turf/simulated/floor/tiled/rough,/area/engineering)
"y" = (/turf/simulated/wall,/area/shuttle/escape)
"z" = (/obj/effect/wingrille_spawn/reinforced,/turf/simulated/floor/plating,/area/shuttle/escape)
"A" = (/obj/machinery/computer/shuttle_control{shuttle_tag = "Example"},/turf/simulated/floor/plating,/area/shuttle/escape)
"B" = (/obj/structure/bed/chair{dir = 1},/obj/machinery/embedded_controller/radio/simple_docking_controller{id_tag = "example_shuttle_starboard"; pixel_x = 28},/obj/machinery/embedded_controller/radio/simple_docking_controller{id_tag = "example_shuttle_port"; pixel_x = -28},/turf/simulated/floor/plating,/area/shuttle/escape)
"C" = (/obj/machinery/camera{dir = 1},/obj/machinery/light/spot,/turf/simulated/floor/plating,/area/shuttle/escape)
"D" = (/obj/machinery/door/airlock/external/bolted{frequency = 1379; id_tag = "example_shuttle_port_hatch"},/turf/simulated/floor/plating,/area/shuttle/escape)
"E" = (/obj/machinery/door/airlock/external/bolted{frequency = 1379; id_tag = "example_shuttle_starboard_hatch"},/turf/simulated/floor/plating,/area/shuttle/escape)
"F" = (/obj/structure/cable{d2 = 2; icon_state = "0-2"},/obj/machinery/power/apc{dir = 8; name = "west bump"; pixel_x = -24},/turf/simulated/floor/tiled/rough,/area/engineering)
"G" = (/obj/structure/cable{d1 = 1; d2 = 2; icon_state = "1-2"},/turf/simulated/floor/tiled/rough,/area/engineering)
"H" = (/obj/structure/cable,/obj/machinery/power/debug_items/infinite_generator,/turf/simulated/floor/tiled/rough,/area/engineering)
"I" = (/obj/machinery/light/spot,/turf/simulated/floor/tiled/rough,/area/engineering)
"J" = (/turf/space,/area/space)
"K" = (/obj/effect/floor_decal/industrial/hatch/yellow,/obj/map_ent/trigger_mob{pixel_x = -7; ev_tag = "ent_tp_wv"; tag = "ent_tp_trigger"},/obj/map_ent/func_teleport{pixel_x = 14; ev_dest_tag = "ent_showcase_tp_dest"; tag = "ent_tp_src"},/obj/map_ent/func_write_var{pixel_y = 9; ev_activate_writer = 1; ev_read_tag = "ent_tp_trigger"; ev_table = list("ev_tag"="ev_triggered"); ev_write_tag = "ent_tp_src"; tag = "ent_tp_wv"},/turf/simulated/floor/tiled/rough,/area/engineering)
"L" = (/obj/machinery/camera{dir = 8},/turf/simulated/floor/tiled/rough,/area/engineering)
"P" = (/obj/map_ent/info_maptext{ev_text = "Map entities showcase"},/turf/simulated/floor/tiled/rough,/area/engineering)
"R" = (/obj/structure/stairs/south,/turf/simulated/floor/tiled/rough,/area/engineering)
"U" = (/obj/effect/floor_decal/industrial/hatch/yellow,/obj/machinery/camera,/obj/machinery/light/spot{dir = 1},/turf/simulated/floor/tiled/rough,/area/engineering)
"X" = (/obj/effect/landmark/joinlate,/turf/simulated/floor/tiled/rough,/area/engineering)
"Z" = (/obj/effect/landmark/start,/turf/simulated/floor/tiled/rough,/area/engineering)

(1,1,1) = {"
JJJJJJJJJJJJJJJJJJJJJJJJJJJJJJJJJJJJJJJJJJJJJJJJ
JJJJJJJJJJJJJJJJJJJJJJJJJJJJJJJJJJJJJJJJJJJJJJJJ
JJJJJJJJJJJJJJJJJJJJJJJJJJJJJJJJJJJJJJJJJJJJJJJJ
JJJJJJJJJJJJJJJJJJJJJJJJJJJJJJJJJJJJJJJJJJJJJJJJ
JJJJJJJJJJJJJJJJJJJJJJJJJJJJJJJJJJJJJJJJJJJJJJJJ
JJJJJJJJJJJJJJJJJJJJJJJJJJJJJJJJJJJJJJJJJJJJJJJJ
JJJJJJJJJJJJJJJJJJJJJJJJJJJJJJJJJJJJJJJJJJJJJJJJ
JJJJJJJJJJJJJJJJJJJJJJJJJJJJJJJJJJJJJJJJJJJJJJJJ
JJJJJJJJJJJJJJJJaaaaaaaaaaaaaaaaaJJJJJJJJJJJJJJJ
JJJJJJJJJJJJJJJJaaaaaaaaaaaaaaaaaJJJJJJJJJJJJJJJ
JJJJJJJJJJJJJJJJaacccdccbccdcccaaJJJJJJJJJJJJJJJ
JJJJJJJJJJJJJJJJaacccccfgfcccccaaJJJJJJJJJJJJJJJ
JJJJJJJJJJJJJJJJaacccccfUfcccchaaJJJJJJJJJJJJJJJ
JJJJJJJJJJJJJJJJaaicccjfffcccckaaJJJJJJJJJJJJJJJ
JJJJJJJJJJJJJJJJaaccccccccccmccaaJJJJJJJJJJJJJJJ
JJJJJJJJJJJJyyyJaaccccccXcccnopaaJJJJJJJJJJJJJJJ
JJJJJJJJJJJJzAzaaaqccccZrlccccLaaJJJJJJJJJJJJJJJ
JJJJJJJJJJJJzBzaaaccccccccccsotaaJJJJJJJJJJJJJJJ
JJJJJJJJJJJJDCEuvwccccccccccxccaaJJJJJJJJJJJJJJJ
JJJJJJJJJJJJyyyaaaiccccccccccckaaJJJJJJJJJJJJJJJ
JJJJJJJJJJJJJJJaaaFccccccccccccaaJJJJJJJJJJJJJJJ
JJJJJJJJJJJJJJJJaaGcccccPccccccaaJJJJJJJJJJJJJJJ
JJJJJJJJJJJJJJJJaaHccIceKccIccRaaJJJJJJJJJJJJJJJ
JJJJJJJJJJJJJJJJaaaaaaaaaaaaaaaaaJJJJJJJJJJJJJJJ
JJJJJJJJJJJJJJJJaaaaaaaaaaaaaaaaaJJJJJJJJJJJJJJJ
JJJJJJJJJJJJJJJJJJJJJJJJJJJJJJJJJJJJJJJJJJJJJJJJ
JJJJJJJJJJJJJJJJJJJJJJJJJJJJJJJJJJJJJJJJJJJJJJJJ
JJJJJJJJJJJJJJJJJJJJJJJJJJJJJJJJJJJJJJJJJJJJJJJJ
JJJJJJJJJJJJJJJJJJJJJJJJJJJJJJJJJJJJJJJJJJJJJJJJ
JJJJJJJJJJJJJJJJJJJJJJJJJJJJJJJJJJJJJJJJJJJJJJJJ
JJJJJJJJJJJJJJJJJJJJJJJJJJJJJJJJJJJJJJJJJJJJJJJJ
JJJJJJJJJJJJJJJJJJJJJJJJJJJJJJJJJJJJJJJJJJJJJJJJ
"}
