"a" = (/turf/space,/area/space)
"b" = (/obj/effect/landmark/map_data{height = 2},/turf/space,/area/space)
"c" = (/turf/simulated/wall/r_wall,/area/rnd/research)
"d" = (/turf/simulated/floor/tiled/rough,/area/rnd/research)
"e" = (/obj/machinery/light/spot{dir = 1},/turf/simulated/floor/tiled/rough,/area/rnd/research)
"f" = (/obj/structure/lattice,/turf/simulated/open,/area/rnd/research)
"g" = (/turf/simulated/open,/area/rnd/research)
"h" = (/obj/machinery/light_switch{on = 1; pixel_x = 25},/turf/simulated/floor/tiled/rough,/area/rnd/research)
"i" = (/obj/effect/shuttle_landmark/upper_level,/turf/space,/area/space)
"j" = (/obj/machinery/camera{dir = 1},/turf/simulated/floor/tiled/rough,/area/rnd/research)
"k" = (/obj/structure/ladder,/obj/structure/railing/steel{dir = 4},/turf/simulated/floor/tiled/rough,/area/rnd/research)
"l" = (/obj/machinery/camera,/turf/simulated/floor,/area/rnd/research)
"m" = (/obj/machinery/embedded_controller/radio/simple_docking_controller{id_tag = "upper_level_dock"; pixel_x = 8; pixel_y = -25},/turf/simulated/floor,/area/rnd/research)
"n" = (/obj/machinery/door/airlock/external/bolted{frequency = 1379},/turf/simulated/floor,/area/rnd/research)
"o" = (/obj/machinery/atmospherics/unary/vent_pump/on,/turf/simulated/floor/tiled/rough,/area/rnd/research)
"p" = (/obj/machinery/light/spot{dir = 4},/turf/simulated/floor/tiled/rough,/area/rnd/research)
"q" = (/obj/machinery/atmospherics/pipe/simple/visible{icon_state = "intact"; dir = 5},/turf/simulated/floor/tiled/rough,/area/rnd/research)
"r" = (/obj/machinery/atmospherics/pipe/simple/visible{icon_state = "intact"; dir = 4},/turf/simulated/floor/tiled/rough,/area/rnd/research)
"s" = (/obj/machinery/atmospherics/portables_connector{icon_state = "map_connector"; dir = 8},/obj/machinery/portable_atmospherics/canister/air,/turf/simulated/floor/tiled/rough,/area/rnd/research)
"t" = (/obj/machinery/atmospherics/pipe/simple/visible{icon_state = "intact"; dir = 6},/turf/simulated/floor/tiled/rough,/area/rnd/research)
"u" = (/obj/machinery/atmospherics/portables_connector{icon_state = "map_connector"; dir = 8},/obj/machinery/portable_atmospherics/canister/empty,/turf/simulated/floor/tiled/rough,/area/rnd/research)
"v" = (/obj/machinery/light_switch{on = 1; pixel_x = -25},/turf/simulated/floor/tiled/rough,/area/rnd/research)
"w" = (/obj/machinery/atmospherics/unary/vent_scrubber/on{icon_state = "map_scrubber_on"; dir = 1},/turf/simulated/floor/tiled/rough,/area/rnd/research)
"x" = (/obj/structure/railing/steel{dir = 1},/turf/simulated/floor/tiled/rough,/area/rnd/research)
"y" = (/obj/structure/cable{d2 = 2; icon_state = "0-2"; pixel_y = 0},/obj/machinery/power/apc{dir = 8; name = "west bump"; pixel_x = -24},/turf/simulated/floor/tiled/rough,/area/rnd/research)
"z" = (/obj/structure/cable{d1 = 1; d2 = 2; icon_state = "1-2"; pixel_y = 0},/turf/simulated/floor/tiled/rough,/area/rnd/research)
"A" = (/obj/structure/cable,/obj/machinery/power/debug_items/infinite_generator,/turf/simulated/floor/tiled/rough,/area/rnd/research)
"B" = (/obj/machinery/light/spot,/turf/simulated/floor/tiled/rough,/area/rnd/research)
"C" = (/obj/machinery/light/spot{dir = 8},/turf/simulated/floor/tiled/rough,/area/rnd/research)
"D" = (/obj/structure/window_frame/rglass,/obj/machinery/light/spot{dir = 1},/turf/simulated/floor,/area/rnd/research)
"E" = (/obj/structure/window_frame/rglass,/turf/simulated/floor,/area/rnd/research)
"F" = (/obj/machinery/camera{dir = 4},/turf/simulated/floor/tiled/rough,/area/rnd/research)
"G" = (/obj/machinery/door/airlock/glass,/turf/simulated/floor/tiled/rough,/area/rnd/research)
"H" = (/obj/structure/railing/steel{dir = 4},/turf/simulated/floor/tiled/rough,/area/rnd/research)
"I" = (/obj/machinery/camera{dir = 4},/turf/space,/area/rnd/research)
"P" = (/obj/machinery/camera{dir = 8},/turf/simulated/floor/tiled/rough,/area/rnd/research)
"R" = (/obj/structure/lattice,/obj/machinery/camera,/turf/simulated/open,/area/rnd/research)
"T" = (/turf/simulated/floor,/area/rnd/research)
"Y" = (/obj/structure/railing/steel{dir = 8},/turf/simulated/floor/tiled/rough,/area/rnd/research)
"Z" = (/obj/structure/railing/steel,/turf/simulated/floor/tiled/rough,/area/rnd/research)

(1,1,1) = {"
aaaaaaaaaaaaaaaaaaaaaaaaaaaaaaaaaaaaaaaaaaaaaaaa
aaaaaaaaaaaaaaaaaaaaaaaaaaaaaaaaaaaaaaaaaaaaaaaa
aaaaaaaaaaaaaaaaaaaaaaaaaaaaaaaaaaaaaaaaaaaaaaaa
aaaaaaaaaaaaaaaaaaaaaaaaaaaaaaaaaaaaaaaaaaaaaaaa
aaaaaaaaaaaaaaaaaaaaaaaaaaaaaaaaaaaaaaaaaaaaaaaa
aaaaaaaaaaaaaaaaaaaaaaaaaaaaaaaaaaaaaaaaaaaaaaaa
aaaaaaaaaaaaaaaaaaaaaaaaaaaaaaaaaaaaaaaaaaaaaaaa
aaaaaaaaaaaaaaaaaaaaaaaaaaaaaaaaaaaaaaaaaaaaaaaa
aaaaaaaaaaaaaaaacccccccccccccccccaaaaaaaaaaaaaaa
aaaaaaaaaaaaabaacccccccccccccccccaaaaaaaaaaaaaaa
aaaaaaaaaaaaaaaaccdddDdZRZdedddccaaaaaaaaaaaaaaa
aaaaaaaaaaaaaaaaccdddEHfffYddddccccaaaaaaaaaaaaa
aaaaaaaaaaaaaaaaccdddEHgggYdddhccccaiaaaaaaaaaaa
aaaaaaaaaaaaaaaaccdddEkgggYddddTlmnaaaaaaaaaaaaa
aaaaaaaaaaaaaaaaccCddEdxxxddodpccccIaaaaaaaaaaaa
aaaaaaaaaaaaaaaaccEGEEddddddqrsccccaaaaaaaaaaaaa
aaaaaaaaaaaaaaaaccFdddddddddddPccaaaaaaaaaaaaaaa
aaaaaaaaaaaaaaaaccddddddddddtruccaaaaaaaaaaaaaaa
aaaaaaaaaaaaaaaaccvdddddddddwddccaaaaaaaaaaaaaaa
aaaaaaaaaaaaaaaaccCdddddddddddpccaaaaaaaaaaaaaaa
aaaaaaaaaaaaaaaaccyddddddddddddccaaaaaaaaaaaaaaa
aaaaaaaaaaaaaaaacczddddddddddgdccaaaaaaaaaaaaaaa
aaaaaaaaaaaaaaaaccAddBddjddBdgdccaaaaaaaaaaaaaaa
aaaaaaaaaaaaaaaacccccccccccccccccaaaaaaaaaaaaaaa
aaaaaaaaaaaaaaaacccccccccccccccccaaaaaaaaaaaaaaa
aaaaaaaaaaaaaaaaaaaaaaaaaaaaaaaaaaaaaaaaaaaaaaaa
aaaaaaaaaaaaaaaaaaaaaaaaaaaaaaaaaaaaaaaaaaaaaaaa
aaaaaaaaaaaaaaaaaaaaaaaaaaaaaaaaaaaaaaaaaaaaaaaa
aaaaaaaaaaaaaaaaaaaaaaaaaaaaaaaaaaaaaaaaaaaaaaaa
aaaaaaaaaaaaaaaaaaaaaaaaaaaaaaaaaaaaaaaaaaaaaaaa
aaaaaaaaaaaaaaaaaaaaaaaaaaaaaaaaaaaaaaaaaaaaaaaa
aaaaaaaaaaaaaaaaaaaaaaaaaaaaaaaaaaaaaaaaaaaaaaaa
"}
