"aK" = (/obj/effect/floor_decal/corner/blue/diagonal,/obj/machinery/computer/operating,/turf/simulated/floor/tiled/white/rough,/area/medical/medbay)
"aU" = (/obj/effect/floor_decal/corner/blue/diagonal,/obj/machinery/light/spot,/turf/simulated/floor/tiled/white/rough,/area/medical/medbay)
"cK" = (/obj/effect/floor_decal/corner/blue/diagonal,/obj/machinery/atmospherics/unary/cryo_cell,/obj/structure/railing/steel{dir = 1},/turf/simulated/floor/tiled/white/rough,/area/medical/medbay)
"dR" = (/obj/effect/floor_decal/corner/blue/diagonal,/turf/simulated/floor/tiled/white/rough,/area/medical/medbay)
"eH" = (/turf/simulated/floor/tiled/dark/rough,/area/medical/medbay)
"eZ" = (/obj/structure/cable{d1 = 1; d2 = 2; icon_state = "1-2"; pixel_y = 0},/obj/effect/floor_decal/corner/blue/diagonal,/turf/simulated/floor/tiled/white/rough,/area/medical/medbay)
"fq" = (/obj/machinery/light_switch{on = 1; pixel_x = -25},/obj/effect/floor_decal/corner/blue/diagonal,/turf/simulated/floor/tiled/white/rough,/area/medical/medbay)
"gA" = (/obj/effect/floor_decal/corner/blue/diagonal,/obj/machinery/camera{dir = 8},/turf/simulated/floor/tiled/white/rough,/area/medical/medbay)
"hq" = (/obj/effect/floor_decal/corner/blue/diagonal,/obj/machinery/organ_printer/flesh/mapped,/turf/simulated/floor/tiled/white/rough,/area/medical/medbay)
"im" = (/obj/effect/floor_decal/corner/blue/diagonal,/obj/structure/table/glass,/obj/item/storage/firstaid/surgery,/turf/simulated/floor/tiled/white/rough,/area/medical/medbay)
"iL" = (/obj/effect/floor_decal/corner/blue/diagonal,/turf/simulated/floor/tiled/white,/area/medical/medbay)
"jG" = (/obj/effect/floor_decal/corner/blue/diagonal,/obj/structure/mirror,/obj/machinery/light/spot{dir = 8},/turf/simulated/floor/tiled/white/rough,/area/medical/medbay)
"kv" = (/obj/effect/floor_decal/corner/blue/diagonal,/obj/machinery/atmospherics/unary/freezer,/obj/structure/railing/steel{dir = 1},/turf/simulated/floor/tiled/white/rough,/area/medical/medbay)
"kw" = (/obj/machinery/atmospherics/pipe/simple/visible{icon_state = "intact"; dir = 6},/obj/effect/floor_decal/corner/blue/diagonal,/turf/simulated/floor/tiled/white/rough,/area/medical/medbay)
"lT" = (/obj/effect/floor_decal/corner/blue/diagonal,/obj/structure/table/rack,/obj/item/stack/material/plasteel/fifty,/obj/item/stack/material/steel/fifty,/obj/item/stack/material/glass/fifty,/obj/item/stack/material/gold/ten,/obj/item/stack/material/mhydrogen/ten,/obj/item/stack/material/silver/ten,/obj/item/stack/material/uranium/ten,/obj/item/stack/material/diamond/ten,/obj/item/stack/material/plasma/fifty,/obj/item/storage/belt/utility/full,/obj/item/stack/material/steel/fifty,/turf/simulated/floor/tiled/white/rough,/area/medical/medbay)
"mX" = (/obj/effect/floor_decal/corner/red{dir = 10},/turf/simulated/floor/tiled/dark/rough,/area/medical/medbay)
"op" = (/obj/effect/floor_decal/corner/blue/diagonal,/obj/machinery/light/spot{dir = 4},/turf/simulated/floor/tiled/white/rough,/area/medical/medbay)
"oO" = (/obj/effect/floor_decal/corner/blue/diagonal,/obj/machinery/bodyscanner{icon_state = "body_scanner_0"; dir = 4},/turf/simulated/floor/tiled/white/rough,/area/medical/medbay)
"qm" = (/turf/space,/area/space)
"su" = (/obj/effect/floor_decal/corner/blue/diagonal,/obj/machinery/mecha_part_fabricator,/turf/simulated/floor/tiled/white,/area/medical/medbay)
"sF" = (/obj/machinery/atmospherics/portables_connector{icon_state = "map_connector"; dir = 8},/obj/machinery/portable_atmospherics/canister/empty,/obj/effect/floor_decal/corner/blue/diagonal,/turf/simulated/floor/tiled/white/rough,/area/medical/medbay)
"tz" = (/obj/effect/floor_decal/corner/red{dir = 9},/turf/simulated/floor/tiled/dark/rough,/area/medical/medbay)
"uG" = (/obj/machinery/atmospherics/unary/vent_scrubber/on{icon_state = "map_scrubber_on"; dir = 1},/obj/effect/floor_decal/corner/blue/diagonal,/turf/simulated/floor/tiled/white/rough,/area/medical/medbay)
"vo" = (/obj/machinery/atmospherics/pipe/simple/visible{icon_state = "intact"; dir = 4},/obj/effect/floor_decal/corner/blue/diagonal,/turf/simulated/floor/tiled/white/rough,/area/medical/medbay)
"vC" = (/obj/effect/floor_decal/corner/blue/diagonal,/obj/structure/table/glass,/obj/item/card/id/all_access,/obj/item/card/id/all_access,/obj/item/card/id/all_access,/turf/simulated/floor/tiled/white/rough,/area/medical/medbay)
"wr" = (/obj/effect/floor_decal/corner/blue/diagonal,/obj/structure/ladder/updown,/turf/simulated/floor/tiled/white/rough,/area/medical/medbay)
"wG" = (/obj/effect/floor_decal/corner/blue/diagonal,/obj/structure/table/glass,/obj/item/storage/box/gloves,/obj/item/storage/box/masks,/turf/simulated/floor/tiled/white/rough,/area/medical/medbay)
"wM" = (/obj/machinery/light_switch{on = 1; pixel_x = 25},/turf/simulated/floor/tiled/dark/rough,/area/medical/medbay)
"yh" = (/obj/effect/floor_decal/corner/blue/diagonal,/obj/machinery/camera{dir = 1},/turf/simulated/floor/tiled/white/rough,/area/medical/medbay)
"zX" = (/obj/structure/cable,/obj/machinery/power/debug_items/infinite_generator,/obj/effect/floor_decal/corner/blue/diagonal,/turf/simulated/floor/tiled/white/rough,/area/medical/medbay)
"Ae" = (/turf/simulated/wall/r_wall,/area/medical/medbay)
"AN" = (/obj/machinery/atmospherics/unary/vent_pump/on,/obj/effect/floor_decal/corner/blue/diagonal,/turf/simulated/floor/tiled/white/rough,/area/medical/medbay)
"BH" = (/obj/effect/floor_decal/corner/blue/diagonal,/obj/machinery/atmospherics/pipe/manifold/visible/blue,/obj/item/reagent_containers/vessel/beaker/cryoxadone,/turf/simulated/floor/tiled/white/rough,/area/medical/medbay)
"CC" = (/obj/effect/floor_decal/corner/blue/diagonal,/obj/machinery/atmospherics/pipe/simple/visible/blue{icon_state = "intact"; dir = 9},/turf/simulated/floor/tiled/white/rough,/area/medical/medbay)
"Dp" = (/obj/effect/landmark/map_data{height = 2},/turf/space,/area/space)
"FQ" = (/obj/structure/lattice,/turf/simulated/open,/area/medical/medbay)
"Gk" = (/obj/effect/floor_decal/corner/blue/diagonal,/obj/structure/railing/steel,/turf/simulated/floor/tiled/white/rough,/area/medical/medbay)
"GM" = (/obj/effect/floor_decal/corner/blue/diagonal,/obj/structure/stairs/north,/turf/simulated/floor/tiled/white/rough,/area/medical/medbay)
"Hh" = (/obj/effect/floor_decal/corner/red{dir = 6},/turf/simulated/floor/tiled/dark/rough,/area/medical/medbay)
"Id" = (/obj/effect/floor_decal/corner/blue/diagonal,/obj/machinery/body_scanconsole{icon_state = "body_scannerconsole"; dir = 4},/turf/simulated/floor/tiled/white/rough,/area/medical/medbay)
"Ix" = (/obj/effect/floor_decal/corner/blue/diagonal,/obj/structure/closet/secure_closet/freezer/meat,/turf/simulated/floor/tiled/white/rough,/area/medical/medbay)
"Iz" = (/obj/effect/floor_decal/corner/blue/diagonal,/obj/machinery/light/spot{dir = 1},/turf/simulated/floor/tiled/white/rough,/area/medical/medbay)
"Je" = (/obj/effect/floor_decal/corner/blue/diagonal,/obj/structure/railing/steel{dir = 8},/turf/simulated/floor/tiled/white/rough,/area/medical/medbay)
"JE" = (/turf/simulated/open,/area/medical/medbay)
"JY" = (/obj/effect/floor_decal/corner/blue/diagonal,/obj/structure/sink{icon_state = "sink"; dir = 4},/obj/structure/railing/steel{dir = 4},/turf/simulated/floor/tiled/white/rough,/area/medical/medbay)
"Kz" = (/obj/effect/floor_decal/corner/blue/diagonal,/obj/structure/table/glass,/obj/item/scalpel/laser1,/obj/item/scalpel/laser2,/obj/item/scalpel/laser3,/obj/item/device/robotanalyzer,/obj/item/device/healthanalyzer,/obj/item/storage/firstaid/adv,/turf/simulated/floor/tiled/white/rough,/area/medical/medbay)
"KC" = (/obj/effect/floor_decal/corner/blue/diagonal,/obj/machinery/organ_printer/robot/mapped,/obj/machinery/camera{dir = 4},/turf/simulated/floor/tiled/white/rough,/area/medical/medbay)
"RG" = (/obj/machinery/atmospherics/portables_connector{icon_state = "map_connector"; dir = 8},/obj/machinery/portable_atmospherics/canister/air,/obj/effect/floor_decal/corner/blue/diagonal,/turf/simulated/floor/tiled/white/rough,/area/medical/medbay)
"SE" = (/obj/structure/cable{d2 = 2; icon_state = "0-2"; pixel_y = 0},/obj/machinery/power/apc{dir = 8; name = "west bump"; pixel_x = -24},/obj/effect/floor_decal/corner/blue/diagonal,/turf/simulated/floor/tiled/white/rough,/area/medical/medbay)
"Tv" = (/obj/effect/floor_decal/corner/red{dir = 5},/turf/simulated/floor/tiled/dark/rough,/area/medical/medbay)
"TF" = (/obj/effect/floor_decal/corner/blue/diagonal,/obj/machinery/sleeper{icon_state = "sleeper_0"; dir = 8},/obj/structure/railing/steel{dir = 4},/turf/simulated/floor/tiled/white/rough,/area/medical/medbay)
"Un" = (/obj/effect/floor_decal/corner/blue/diagonal,/obj/machinery/optable,/obj/machinery/oxygen_pump/anesthetic{pixel_y = 32},/turf/simulated/floor/tiled/white/rough,/area/medical/medbay)
"UX" = (/obj/structure/lattice,/obj/machinery/camera,/turf/simulated/open,/area/medical/medbay)
"Vl" = (/obj/machinery/atmospherics/pipe/simple/visible{icon_state = "intact"; dir = 5},/obj/effect/floor_decal/corner/blue/diagonal,/turf/simulated/floor/tiled/white/rough,/area/medical/medbay)
"VK" = (/obj/effect/floor_decal/corner/blue/diagonal,/obj/machinery/atmospherics/pipe/simple/visible/blue{icon_state = "intact"; dir = 5},/turf/simulated/floor/tiled/white/rough,/area/medical/medbay)
"Wj" = (/obj/effect/floor_decal/corner/blue/diagonal,/obj/structure/iv_drip,/obj/item/reagent_containers/ivbag/blood/OMinus,/obj/item/reagent_containers/ivbag/blood/OMinus,/obj/item/reagent_containers/ivbag/blood/OMinus,/turf/simulated/floor/tiled/white/rough,/area/medical/medbay)
"Xk" = (/mob/living/carbon/human/dummy,/obj/effect/floor_decal/bot_red,/turf/simulated/floor/tiled/dark/rough,/area/medical/medbay)
"Yk" = (/obj/effect/floor_decal/corner/blue/diagonal,/obj/structure/table/glass,/obj/item/reagent_containers/dropper,/obj/item/reagent_containers/chem_disp_cartridge/peridaxon,/obj/item/stack/nanopaste,/obj/machinery/light/spot{dir = 8},/turf/simulated/floor/tiled/white/rough,/area/medical/medbay)
"YD" = (/obj/effect/floor_decal/corner/blue/diagonal,/obj/structure/table/glass,/obj/item/storage/box/syringes,/obj/item/storage/box/freezer,/obj/machinery/light/spot{dir = 1},/turf/simulated/floor/tiled/white/rough,/area/medical/medbay)
"Zg" = (/obj/effect/floor_decal/corner/blue/diagonal,/obj/machinery/portable_atmospherics/canister/oxygen/prechilled,/obj/machinery/atmospherics/portables_connector,/obj/structure/railing/steel{dir = 1},/turf/simulated/floor/tiled/white/rough,/area/medical/medbay)

(1,1,1) = {"
qmqmqmqmqmqmqmqmqmqmqmqmqmqmqmqmqmqmqmqmqmqmqmqmqmqmqmqmqmqmqmqmqmqmqmqmqmqmqmqmqmqmqmqmqmqmqmqm
qmqmqmqmqmqmqmqmqmqmqmqmqmqmqmqmqmqmqmqmqmqmqmqmqmqmqmqmqmqmqmqmqmqmqmqmqmqmqmqmqmqmqmqmqmqmqmqm
qmqmqmqmqmqmqmqmqmqmqmqmqmqmqmqmqmqmqmqmqmqmqmqmqmqmqmqmqmqmqmqmqmqmqmqmqmqmqmqmqmqmqmqmqmqmqmqm
qmqmqmqmqmqmqmqmqmqmqmqmqmqmqmqmqmqmqmqmqmqmqmqmqmqmqmqmqmqmqmqmqmqmqmqmqmqmqmqmqmqmqmqmqmqmqmqm
qmqmqmqmqmqmqmqmqmqmqmqmqmqmqmqmqmqmqmqmqmqmqmqmqmqmqmqmqmqmqmqmqmqmqmqmqmqmqmqmqmqmqmqmqmqmqmqm
qmqmqmqmqmqmqmqmqmqmqmqmqmqmqmqmqmqmqmqmqmqmqmqmqmqmqmqmqmqmqmqmqmqmqmqmqmqmqmqmqmqmqmqmqmqmqmqm
qmqmqmqmqmqmqmqmqmqmqmqmqmqmqmqmqmqmqmqmqmqmqmqmqmqmqmqmqmqmqmqmqmqmqmqmqmqmqmqmqmqmqmqmqmqmqmqm
qmqmqmqmqmqmqmqmqmqmqmqmqmqmqmqmqmqmqmqmqmqmqmqmqmqmqmqmqmqmqmqmqmqmqmqmqmqmqmqmqmqmqmqmqmqmqmqm
qmqmqmqmqmqmqmqmqmqmqmqmqmqmqmqmAeAeAeAeAeAeAeAeAeAeAeAeAeAeAeAeAeqmqmqmqmqmqmqmqmqmqmqmqmqmqmqm
qmqmqmqmqmqmqmqmqmqmqmqmqmDpqmqmAeAeAeAeAeAeAeAeAeAeAeAeAeAeAeAeAeqmqmqmqmqmqmqmqmqmqmqmqmqmqmqm
qmqmqmqmqmqmqmqmqmqmqmqmqmqmqmqmAeAeWjUnaKYDwGGkUXGkdRIzeHmXeHAeAeqmqmqmqmqmqmqmqmqmqmqmqmqmqmqm
qmqmqmqmqmqmqmqmqmqmqmqmqmqmqmqmAeAeimdRdRdRJYFQFQFQJedRHhXktzAeAeqmqmqmqmqmqmqmqmqmqmqmqmqmqmqm
qmqmqmqmqmqmqmqmqmqmqmqmqmqmqmqmAeAeYkIdoOdRTFJEJEJEJedReHTvwMAeAeqmqmqmqmqmqmqmqmqmqmqmqmqmqmqm
qmqmqmqmqmqmqmqmqmqmqmqmqmqmqmqmAeAeKzdRdRdRwrkvcKZgdRdRdRdRopAeAeqmqmqmqmqmqmqmqmqmqmqmqmqmqmqm
qmqmqmqmqmqmqmqmqmqmqmqmqmqmqmqmAeAeIxdRsudRdRVKBHCCdRdRANdRdRAeAeqmqmqmqmqmqmqmqmqmqmqmqmqmqmqm
qmqmqmqmqmqmqmqmqmqmqmqmqmqmqmqmAeAehqdRdRdRdRdRdRdRdRdRVlvoRGAeAeqmqmqmqmqmqmqmqmqmqmqmqmqmqmqm
qmqmqmqmqmqmqmqmqmqmqmqmqmqmqmqmAeAeKCdRlTdRdRdRdRdRdRdRdRdRgAAeAeqmqmqmqmqmqmqmqmqmqmqmqmqmqmqm
qmqmqmqmqmqmqmqmqmqmqmqmqmqmqmqmAeAevCdRdRdRdRdRdRiLiLdRkwvosFAeAeqmqmqmqmqmqmqmqmqmqmqmqmqmqmqm
qmqmqmqmqmqmqmqmqmqmqmqmqmqmqmqmAeAefqdRdRdRdRdRdRdRdRdRuGdRdRAeAeqmqmqmqmqmqmqmqmqmqmqmqmqmqmqm
qmqmqmqmqmqmqmqmqmqmqmqmqmqmqmqmAeAejGdRdRdRdRdRdRdRdRdRdRdRopAeAeqmqmqmqmqmqmqmqmqmqmqmqmqmqmqm
qmqmqmqmqmqmqmqmqmqmqmqmqmqmqmqmAeAeSEdRdRdRdRdRdRdRdRdRdRdRdRAeAeqmqmqmqmqmqmqmqmqmqmqmqmqmqmqm
qmqmqmqmqmqmqmqmqmqmqmqmqmqmqmqmAeAeeZdRdRdRdRdRdRdRdRdRdRGMJEAeAeqmqmqmqmqmqmqmqmqmqmqmqmqmqmqm
qmqmqmqmqmqmqmqmqmqmqmqmqmqmqmqmAeAezXdRdRaUdRdRyhdRdRaUdRdRJEAeAeqmqmqmqmqmqmqmqmqmqmqmqmqmqmqm
qmqmqmqmqmqmqmqmqmqmqmqmqmqmqmqmAeAeAeAeAeAeAeAeAeAeAeAeAeAeAeAeAeqmqmqmqmqmqmqmqmqmqmqmqmqmqmqm
qmqmqmqmqmqmqmqmqmqmqmqmqmqmqmqmAeAeAeAeAeAeAeAeAeAeAeAeAeAeAeAeAeqmqmqmqmqmqmqmqmqmqmqmqmqmqmqm
qmqmqmqmqmqmqmqmqmqmqmqmqmqmqmqmqmqmqmqmqmqmqmqmqmqmqmqmqmqmqmqmqmqmqmqmqmqmqmqmqmqmqmqmqmqmqmqm
qmqmqmqmqmqmqmqmqmqmqmqmqmqmqmqmqmqmqmqmqmqmqmqmqmqmqmqmqmqmqmqmqmqmqmqmqmqmqmqmqmqmqmqmqmqmqmqm
qmqmqmqmqmqmqmqmqmqmqmqmqmqmqmqmqmqmqmqmqmqmqmqmqmqmqmqmqmqmqmqmqmqmqmqmqmqmqmqmqmqmqmqmqmqmqmqm
qmqmqmqmqmqmqmqmqmqmqmqmqmqmqmqmqmqmqmqmqmqmqmqmqmqmqmqmqmqmqmqmqmqmqmqmqmqmqmqmqmqmqmqmqmqmqmqm
qmqmqmqmqmqmqmqmqmqmqmqmqmqmqmqmqmqmqmqmqmqmqmqmqmqmqmqmqmqmqmqmqmqmqmqmqmqmqmqmqmqmqmqmqmqmqmqm
qmqmqmqmqmqmqmqmqmqmqmqmqmqmqmqmqmqmqmqmqmqmqmqmqmqmqmqmqmqmqmqmqmqmqmqmqmqmqmqmqmqmqmqmqmqmqmqm
qmqmqmqmqmqmqmqmqmqmqmqmqmqmqmqmqmqmqmqmqmqmqmqmqmqmqmqmqmqmqmqmqmqmqmqmqmqmqmqmqmqmqmqmqmqmqmqm
"}
