//MAP CONVERTED BY dmm2tgm.py THIS HEADER COMMENT PREVENTS RECONVERSION, DO NOT REMOVE
"a" = (
/turf/template_noop,
/area/template_noop)
"b" = (
/turf/simulated/shuttle/wall/merchant,
/area/ruin/powered)
"e" = (
/obj/structure/shuttle/engine/propulsion{
	dir = 8
	},
/turf/simulated/floor/plating/airless,
/area/ruin/powered)
"f" = (
/obj/structure/window/reinforced{
	dir = 4
	},
/obj/structure/shuttle/engine/heater{
	dir = 8
	},
/turf/simulated/floor/plating/airless,
/area/ruin/powered)
"g" = (
/obj/item/clothing/under/shorts/black,
/obj/structure/table/woodentable,
/turf/simulated/floor/shuttle/blue,
/area/ruin/powered)
"i" = (
/obj/structure/table/reinforced,
/obj/machinery/light{
	dir = 1
	},
/obj/item/device/flashlight/lamp,
/turf/simulated/floor/shuttle/blue,
/area/ruin/powered)
"j" = (
/obj/structure/closet,
/turf/simulated/floor/shuttle/blue,
/area/ruin/powered)
"k" = (
/obj/machinery/vending/assist,
/turf/simulated/floor/shuttle/blue,
/area/ruin/powered)
"l" = (
/obj/item/clothing/shoes/sandal,
/obj/structure/table/woodentable,
/turf/simulated/floor/shuttle/blue,
/area/ruin/powered)
"m" = (
/obj/machinery/light{
	dir = 8
	},
/turf/simulated/floor/shuttle/blue,
/area/ruin/powered)
"n" = (
/obj/structure/table/woodentable,
/turf/simulated/floor/shuttle/blue,
/area/ruin/powered)
"p" = (
/obj/structure/window_frame/grille/rglass,
/turf/simulated/floor/plating,
/area/ruin/powered)
"r" = (
/obj/structure/table/reinforced,
/obj/item/paper_bin,
/obj/item/pen,
/turf/simulated/floor/shuttle/blue,
/area/ruin/powered)
"s" = (
/obj/machinery/door/blast/shutters,
/turf/simulated/floor/shuttle/blue,
/area/ruin/powered)
"t" = (
/obj/machinery/door/airlock/external,
/turf/simulated/floor/shuttle/blue,
/area/ruin/powered)
"u" = (
/obj/machinery/door/airlock/glass{
	name = "Fitness"
	},
/turf/simulated/floor/shuttle/blue,
/area/ruin/powered)
"v" = (
/obj/structure/bed/chair/shuttle/black{
	dir = 4
	},
/turf/simulated/floor/shuttle/blue,
/area/ruin/powered)
"w" = (
/obj/structure/table/reinforced,
/obj/item/paper,
/obj/item/pen,
/turf/simulated/floor/shuttle/blue,
/area/ruin/powered)
"x" = (
/obj/machinery/button/remote/blast_door,
/turf/simulated/shuttle/wall/merchant,
/area/ruin/powered)
"y" = (
/obj/machinery/light,
/turf/simulated/floor/shuttle/blue,
/area/ruin/powered)
"z" = (
/turf/simulated/floor/shuttle/blue,
/area/ruin/powered)
"B" = (
/obj/structure/bed/chair/shuttle/black,
/turf/simulated/floor/shuttle/blue,
/area/ruin/powered)
"D" = (
/obj/machinery/light,
/obj/structure/bed,
/turf/simulated/floor/shuttle/blue,
/area/ruin/powered)

(1,1,1) = {"
a
a
a
b
b
s
x
b
a
a
a
"}
(2,1,1) = {"
a
e
e
b
n
z
z
b
e
e
a
"}
(3,1,1) = {"
b
f
f
b
n
z
y
b
f
f
b
"}
(4,1,1) = {"
b
g
l
b
p
t
p
b
B
n
b
"}
(5,1,1) = {"
b
z
z
b
z
z
z
b
z
n
b
"}
(6,1,1) = {"
b
i
z
m
z
z
z
m
z
D
b
"}
(7,1,1) = {"
b
j
z
z
z
z
z
z
z
z
b
"}
(8,1,1) = {"
b
k
z
z
z
z
z
z
z
j
b
"}
(9,1,1) = {"
b
b
b
b
p
u
p
b
b
b
b
"}
(10,1,1) = {"
a
a
b
m
z
z
z
m
b
a
a
"}
(11,1,1) = {"
a
a
b
z
z
v
z
z
b
a
a
"}
(12,1,1) = {"
a
a
b
j
r
w
n
j
b
a
a
"}
(13,1,1) = {"
a
a
b
b
b
b
b
b
b
a
a
"}
