"a" = (/turf/floor/tiled/dark/rough,/area/template_noop)
"b" = (/obj/effect/floor_decal/industrial/warning/corner{dir = 4},/turf/floor/tiled/dark/rough,/area/template_noop)
"d" = (/obj/effect/floor_decal/industrial/warning/corner,/turf/floor/tiled/dark/rough,/area/template_noop)
"f" = (/obj/machinery/door/window/northright,/obj/effect/floor_decal/stairs,/turf/floor/tiled/dark/rough,/area/template_noop)
"g" = (/obj/effect/floor_decal/corner/red/three_quarters,/obj/effect/floor_decal/corner/grey{dir = 4},/turf/floor/tiled,/area/template_noop)
"h" = (/obj/effect/floor_decal/corner/green/three_quarters{dir = 1},/obj/effect/floor_decal/corner/grey{dir = 8},/turf/floor/tiled,/area/template_noop)
"l" = (/obj/effect/floor_decal/industrial/warning/corner{dir = 1},/turf/floor/tiled/dark/rough,/area/template_noop)
"m" = (/obj/effect/floor_decal/corner/grey/full,/turf/floor/tiled,/area/template_noop)
"n" = (/obj/effect/floor_decal/corner/green/three_quarters,/obj/effect/floor_decal/corner/grey{dir = 4},/obj/structure/window/basic{dir = 8},/turf/floor/tiled,/area/template_noop)
"o" = (/obj/structure/table/steel_reinforced,/obj/effect/floor_decal/industrial/hatch/yellow,/obj/machinery/button/minigame,/turf/floor/tiled/dark/rough,/area/template_noop)
"p" = (/obj/effect/floor_decal/corner/green{dir = 5},/obj/effect/floor_decal/corner/grey{dir = 10},/turf/floor/tiled,/area/template_noop)
"q" = (/obj/effect/floor_decal/corner/red{dir = 5},/obj/effect/floor_decal/corner/grey{dir = 10},/turf/floor/tiled,/area/template_noop)
"r" = (/obj/effect/floor_decal/corner/red{dir = 6},/obj/effect/floor_decal/corner/grey{dir = 9},/obj/structure/window/basic{dir = 4},/turf/floor/tiled,/area/template_noop)
"t" = (/obj/machinery/door/window/northleft,/obj/effect/floor_decal/stairs,/turf/floor/tiled/dark/rough,/area/template_noop)
"u" = (/obj/structure/table/steel_reinforced,/obj/item/clothing/suit/armor/tdome/red,/obj/item/clothing/head/helmet/thunderdome,/obj/item/melee/energy/axe,/turf/floor/tiled/dark/rough,/area/template_noop)
"x" = (/obj/effect/floor_decal/corner/green{dir = 6},/obj/effect/floor_decal/corner/grey{dir = 9},/turf/floor/tiled,/area/template_noop)
"y" = (/obj/effect/floor_decal/corner/red/three_quarters{dir = 4},/obj/effect/floor_decal/corner/grey{dir = 1},/obj/structure/window/basic{dir = 4},/turf/floor/tiled,/area/template_noop)
"z" = (/obj/structure/table/steel_reinforced,/obj/item/clothing/suit/armor/tdome/green,/obj/item/clothing/head/helmet/thunderdome,/obj/item/melee/energy/sword/dualsaber/green,/turf/floor/tiled/dark/rough,/area/template_noop)
"A" = (/obj/structure/table/steel_reinforced,/turf/floor/tiled/dark/rough,/area/template_noop)
"B" = (/obj/structure/window/reinforced{dir = 8},/obj/effect/floor_decal/industrial/warning{dir = 8},/turf/floor/tiled/dark/rough,/area/template_noop)
"C" = (/obj/structure/window/reinforced{dir = 4},/obj/effect/floor_decal/industrial/warning{dir = 4},/turf/floor/tiled/dark/rough,/area/template_noop)
"D" = (/obj/structure/window/reinforced,/obj/effect/floor_decal/industrial/warning,/obj/structure/bed/chair/green,/turf/floor/tiled/rough,/area/template_noop)
"E" = (/obj/effect/floor_decal/corner/green/three_quarters{dir = 4},/obj/effect/floor_decal/corner/grey{dir = 1},/turf/floor/tiled,/area/template_noop)
"F" = (/obj/structure/window/reinforced{dir = 1; health = null},/obj/effect/floor_decal/industrial/warning{dir = 1},/obj/structure/bed/chair/red{dir = 1},/turf/floor/tiled/rough,/area/template_noop)
"H" = (/obj/machinery/door/window/southright,/obj/effect/floor_decal/stairs{dir = 1},/turf/floor/tiled/dark/rough,/area/template_noop)
"I" = (/obj/effect/floor_decal/corner/green/three_quarters{dir = 8},/obj/structure/window/basic{dir = 8},/turf/floor/tiled,/area/template_noop)
"K" = (/obj/structure/window/reinforced,/obj/effect/floor_decal/industrial/warning,/obj/structure/bed/chair/red,/turf/floor/tiled/rough,/area/template_noop)
"M" = (/obj/structure/table/steel_reinforced,/obj/item/clothing/suit/armor/tdome/green,/obj/item/clothing/head/helmet/thunderdome,/obj/item/melee/energy/axe,/turf/floor/tiled/dark/rough,/area/template_noop)
"N" = (/obj/effect/floor_decal/industrial/warning/corner{dir = 8},/turf/floor/tiled/dark/rough,/area/template_noop)
"O" = (/obj/effect/floor_decal/corner/green{dir = 10},/obj/effect/floor_decal/corner/grey{dir = 5},/turf/floor/tiled,/area/template_noop)
"P" = (/obj/effect/floor_decal/corner/red/three_quarters{dir = 1},/obj/effect/floor_decal/corner/grey{dir = 8},/obj/structure/window/basic{dir = 4},/turf/floor/tiled,/area/template_noop)
"Q" = (/obj/effect/floor_decal/corner/red{dir = 10},/obj/effect/floor_decal/corner/grey{dir = 5},/turf/floor/tiled,/area/template_noop)
"R" = (/obj/effect/floor_decal/corner/red/three_quarters{dir = 8},/obj/effect/floor_decal/corner/grey,/turf/floor/tiled,/area/template_noop)
"U" = (/obj/structure/window/reinforced{dir = 1; health = null},/obj/effect/floor_decal/industrial/warning{dir = 1},/obj/structure/bed/chair/green{dir = 1},/turf/floor/tiled/rough,/area/template_noop)
"V" = (/obj/effect/floor_decal/corner/red{dir = 9},/obj/effect/floor_decal/corner/grey{dir = 6},/turf/floor/tiled,/area/template_noop)
"W" = (/obj/machinery/door/window/southleft,/obj/effect/floor_decal/stairs{dir = 1},/turf/floor/tiled/dark/rough,/area/template_noop)
"Y" = (/obj/effect/floor_decal/corner/green{dir = 9},/obj/effect/floor_decal/corner/grey{dir = 6},/obj/structure/window/basic{dir = 8},/turf/floor/tiled,/area/template_noop)
"Z" = (/obj/structure/table/steel_reinforced,/obj/item/clothing/suit/armor/tdome/red,/obj/item/clothing/head/helmet/thunderdome,/obj/item/melee/energy/sword/dualsaber/red,/turf/floor/tiled/dark/rough,/area/template_noop)

(1,1,1) = {"
aaaaaaaaaa
dKKWKDHDDN
CuRqPIphMB
CuVmrYmxMB
CuVmrYmxMB
CZVmrYmxzB
CAVmrYmxAB
CogQynOEoB
bFFtFUfUUl
aaaaaaaaaa
"}
