"a" = (/obj/effect/floor_decal/corner/red{dir = 9},/turf/simulated/floor/holofloor/tiled,/area/template_noop)
"d" = (/obj/effect/floor_decal/corner/red{dir = 6},/obj/item/beach_ball/holoball,/turf/simulated/floor/holofloor/tiled,/area/template_noop)
"e" = (/obj/effect/floor_decal/corner/red/three_quarters,/turf/simulated/floor/holofloor/tiled,/area/template_noop)
"g" = (/obj/effect/floor_decal/corner/green/three_quarters{dir = 1},/turf/simulated/floor/holofloor/tiled,/area/template_noop)
"h" = (/obj/effect/floor_decal/corner/green{dir = 6},/turf/simulated/floor/holofloor/tiled,/area/template_noop)
"l" = (/obj/structure/holostool,/obj/structure/window/reinforced/holowindow{dir = 1},/turf/simulated/floor/holofloor/tiled,/area/template_noop)
"o" = (/obj/effect/floor_decal/corner/red/three_quarters{dir = 1},/turf/simulated/floor/holofloor/tiled,/area/template_noop)
"p" = (/turf/simulated/floor/holofloor/tiled/dark,/area/template_noop)
"q" = (/obj/effect/floor_decal/corner/red{dir = 10},/turf/simulated/floor/holofloor/tiled,/area/template_noop)
"r" = (/obj/effect/floor_decal/corner/red{dir = 5},/turf/simulated/floor/holofloor/tiled,/area/template_noop)
"s" = (/obj/structure/holohoop{dir = 4},/obj/effect/floor_decal/corner/red{dir = 9},/turf/simulated/floor/holofloor/tiled,/area/template_noop)
"t" = (/obj/effect/floor_decal/corner/green/three_quarters{dir = 4},/turf/simulated/floor/holofloor/tiled,/area/template_noop)
"v" = (/obj/effect/floor_decal/corner/red/three_quarters{dir = 8},/turf/simulated/floor/holofloor/tiled,/area/template_noop)
"y" = (/obj/machinery/door/window/holowindoor{base_state = "right"; dir = 1; icon_state = "right"; name = "Green Team"},/turf/simulated/floor/holofloor/tiled/dark,/area/template_noop)
"z" = (/obj/effect/floor_decal/corner/green{dir = 5},/turf/simulated/floor/holofloor/tiled,/area/template_noop)
"A" = (/turf/simulated/floor/holofloor/tiled,/area/template_noop)
"F" = (/obj/structure/holohoop{dir = 8},/obj/effect/floor_decal/corner/green{dir = 6},/turf/simulated/floor/holofloor/tiled,/area/template_noop)
"J" = (/obj/effect/floor_decal/corner/green/three_quarters,/turf/simulated/floor/holofloor/tiled,/area/template_noop)
"K" = (/obj/effect/floor_decal/corner/red{dir = 6},/turf/simulated/floor/holofloor/tiled,/area/template_noop)
"L" = (/obj/machinery/door/window/holowindoor{dir = 1; name = "Red Team"},/turf/simulated/floor/holofloor/tiled/dark,/area/template_noop)
"M" = (/obj/structure/holostool,/turf/simulated/floor/holofloor/tiled,/area/template_noop)
"O" = (/obj/effect/floor_decal/corner/red/three_quarters{dir = 4},/turf/simulated/floor/holofloor/tiled,/area/template_noop)
"S" = (/obj/effect/floor_decal/corner/green/three_quarters{dir = 8},/turf/simulated/floor/holofloor/tiled,/area/template_noop)
"V" = (/obj/effect/floor_decal/corner/green{dir = 10},/turf/simulated/floor/holofloor/tiled,/area/template_noop)
"W" = (/obj/effect/floor_decal/corner/green{dir = 9},/turf/simulated/floor/holofloor/tiled,/area/template_noop)

(1,1,1) = {"
vrrroSzzzg
aAAAKWAAAh
vraAKWAhzg
sAaAdWAhAF
eqaAKWAhVt
aAAAKWAAAh
eqqqOJVVVt
llyllllLll
MMpMMMMpMM
pppppppppp
"}
