"a" = (/obj/effect/floor_decal/corner/red{dir = 5},/turf/simulated/floor/holofloor/tiled,/area/template_noop)
"i" = (/obj/item/stool/padded,/turf/simulated/floor/holofloor/tiled,/area/template_noop)
"k" = (/obj/effect/floor_decal/corner/green/three_quarters{dir = 1},/turf/simulated/floor/holofloor/tiled,/area/template_noop)
"r" = (/obj/effect/floor_decal/corner/green{dir = 6},/turf/simulated/floor/holofloor/tiled,/area/template_noop)
"v" = (/turf/simulated/floor/holofloor/tiled,/area/template_noop)
"x" = (/obj/effect/floor_decal/corner/red/three_quarters,/turf/simulated/floor/holofloor/tiled,/area/template_noop)
"y" = (/obj/machinery/door/window{dir = 1; name = "Red Team"},/turf/simulated/floor/holofloor/tiled/dark,/area/template_noop)
"z" = (/obj/effect/floor_decal/corner/green{dir = 10},/turf/simulated/floor/holofloor/tiled,/area/template_noop)
"C" = (/obj/effect/floor_decal/corner/green{dir = 5},/turf/simulated/floor/holofloor/tiled,/area/template_noop)
"D" = (/obj/effect/floor_decal/corner/red{dir = 10},/turf/simulated/floor/holofloor/tiled,/area/template_noop)
"F" = (/obj/item/stool/padded,/obj/structure/window/reinforced{dir = 1},/turf/simulated/floor/holofloor/tiled,/area/template_noop)
"H" = (/obj/effect/floor_decal/corner/green/three_quarters{dir = 4},/turf/simulated/floor/holofloor/tiled,/area/template_noop)
"N" = (/turf/simulated/floor/holofloor/tiled/dark,/area/template_noop)
"O" = (/obj/effect/floor_decal/corner/red{dir = 9},/turf/simulated/floor/holofloor/tiled,/area/template_noop)
"V" = (/obj/effect/floor_decal/corner/red/three_quarters{dir = 8},/turf/simulated/floor/holofloor/tiled,/area/template_noop)
"Y" = (/obj/machinery/door/window{base_state = "right"; dir = 1; icon_state = "right"; name = "Green Team"},/turf/simulated/floor/holofloor/tiled/dark,/area/template_noop)

(1,1,1) = {"
VaaaaCCCCk
Ovvvvvvvvr
Ovvvvvvvvr
Ovvvvvvvvr
Ovvvvvvvvr
Ovvvvvvvvr
xDDDDzzzzH
FFYFFFFyFF
iiNiiiiNii
NNNNNNNNNN
"}
