"a" = (/obj/structure/bed/chair/black,/obj/effect/floor_decal/corner/red/full,/turf/floor/tiled/brown,/area/template_noop)
"b" = (/obj/structure/table/reinforced,/obj/item/clothing/gloves/boxing/hologloves,/obj/effect/floor_decal/corner/red/full,/obj/effect/floor_decal/spline/fancy{dir = 9},/turf/floor/tiled/brown,/area/template_noop)
"c" = (/obj/effect/floor_decal/corner/blue/three_quarters,/obj/effect/floor_decal/industrial/boxcorners{dir = 8},/turf/floor/tiled/brown,/area/template_noop)
"d" = (/obj/effect/floor_decal/corner/red/three_quarters{dir = 8},/obj/effect/floor_decal/industrial/boxcorners{dir = 1},/turf/floor/tiled/brown,/area/template_noop)
"f" = (/turf/floor/tiled/dark/rough,/area/template_noop)
"g" = (/obj/structure/window/reinforced{dir = 4},/obj/effect/floor_decal/industrial/warning{dir = 4},/turf/floor/tiled/dark/rough,/area/template_noop)
"h" = (/obj/effect/floor_decal/corner/green/three_quarters{dir = 4},/obj/effect/floor_decal/industrial/boxcorners,/turf/floor/tiled/brown,/area/template_noop)
"i" = (/obj/effect/floor_decal/industrial/warning/corner{dir = 4},/turf/floor/tiled/dark/rough,/area/template_noop)
"j" = (/obj/effect/floor_decal/corner/yellow{dir = 4},/turf/floor/tiled/brown,/area/template_noop)
"n" = (/obj/effect/floor_decal/corner/yellow/full,/obj/effect/floor_decal/spline/fancy{dir = 1},/obj/structure/table/reinforced,/obj/item/clothing/gloves/boxing/hologloves/yellow,/turf/floor/tiled/brown,/area/template_noop)
"p" = (/obj/structure/table/reinforced,/obj/item/clothing/gloves/boxing/hologloves/blue,/obj/effect/floor_decal/corner/blue/full,/obj/effect/floor_decal/spline/fancy{dir = 10},/turf/floor/tiled/brown,/area/template_noop)
"q" = (/obj/structure/window/reinforced{dir = 1; health = null},/obj/effect/floor_decal/industrial/warning{dir = 1},/turf/floor/tiled/dark/rough,/area/template_noop)
"s" = (/obj/structure/table/reinforced,/obj/item/clothing/gloves/boxing/hologloves/green,/obj/effect/floor_decal/corner/green/full,/obj/effect/floor_decal/spline/fancy{dir = 6},/turf/floor/tiled/brown,/area/template_noop)
"t" = (/obj/effect/floor_decal/corner/green/full,/obj/effect/floor_decal/spline/fancy{dir = 4},/obj/structure/table/reinforced,/obj/item/clothing/gloves/boxing/hologloves/green,/turf/floor/tiled/brown,/area/template_noop)
"u" = (/obj/effect/floor_decal/corner/yellow/three_quarters{dir = 1},/obj/effect/floor_decal/industrial/boxcorners{dir = 4},/turf/floor/tiled/brown,/area/template_noop)
"v" = (/obj/effect/floor_decal/industrial/warning/corner{dir = 1},/turf/floor/tiled/dark/rough,/area/template_noop)
"w" = (/obj/effect/floor_decal/corner/grey/three_quarters{dir = 4},/obj/effect/floor_decal/industrial/boxcorners{dir = 1},/turf/floor/tiled/dark,/area/template_noop)
"x" = (/obj/effect/floor_decal/corner/blue/full,/obj/effect/floor_decal/spline/fancy,/obj/structure/table/reinforced,/obj/item/clothing/gloves/boxing/hologloves/blue,/turf/floor/tiled/brown,/area/template_noop)
"y" = (/obj/structure/table/reinforced,/obj/item/clothing/gloves/boxing/hologloves/yellow,/obj/effect/floor_decal/corner/yellow/full,/obj/effect/floor_decal/spline/fancy{dir = 5},/turf/floor/tiled/brown,/area/template_noop)
"z" = (/obj/effect/floor_decal/corner/red{dir = 1},/turf/floor/tiled/brown,/area/template_noop)
"A" = (/obj/structure/window/reinforced,/obj/effect/floor_decal/industrial/warning,/turf/floor/tiled/dark/rough,/area/template_noop)
"C" = (/obj/structure/bed/chair/black{dir = 1},/obj/effect/floor_decal/corner/green/full,/turf/floor/tiled/brown,/area/template_noop)
"D" = (/obj/effect/floor_decal/industrial/warning/corner{dir = 8},/turf/floor/tiled/dark/rough,/area/template_noop)
"F" = (/obj/effect/floor_decal/spline/fancy{dir = 8},/turf/floor/tiled/dark/rough,/area/template_noop)
"H" = (/obj/machinery/door/window/southleft,/obj/effect/floor_decal/industrial/warning,/turf/floor/tiled/dark/rough,/area/template_noop)
"I" = (/obj/structure/bed/chair/black{dir = 8},/obj/effect/floor_decal/corner/yellow/full,/turf/floor/tiled/brown,/area/template_noop)
"J" = (/obj/effect/floor_decal/corner/grey/three_quarters{dir = 1},/obj/effect/floor_decal/industrial/boxcorners{dir = 8},/turf/floor/tiled/dark,/area/template_noop)
"K" = (/obj/effect/floor_decal/spline/fancy{dir = 1},/turf/floor/tiled/dark/rough,/area/template_noop)
"M" = (/obj/machinery/door/window/northright,/obj/effect/floor_decal/industrial/warning{dir = 1},/turf/floor/tiled/dark/rough,/area/template_noop)
"N" = (/obj/effect/floor_decal/spline/fancy,/turf/floor/tiled/dark/rough,/area/template_noop)
"P" = (/obj/effect/floor_decal/corner/green,/turf/floor/tiled/brown,/area/template_noop)
"Q" = (/obj/effect/floor_decal/corner/grey/three_quarters,/obj/effect/floor_decal/industrial/boxcorners{dir = 4},/turf/floor/tiled/dark,/area/template_noop)
"R" = (/obj/effect/floor_decal/corner/blue{dir = 8},/turf/floor/tiled/brown,/area/template_noop)
"S" = (/obj/structure/bed/chair/black{dir = 4},/obj/effect/floor_decal/corner/blue/full,/turf/floor/tiled/brown,/area/template_noop)
"T" = (/obj/effect/floor_decal/industrial/warning/corner,/turf/floor/tiled/dark/rough,/area/template_noop)
"U" = (/obj/structure/window/reinforced{dir = 8},/obj/effect/floor_decal/industrial/warning{dir = 8},/turf/floor/tiled/dark/rough,/area/template_noop)
"V" = (/obj/effect/floor_decal/corner/red/full,/obj/effect/floor_decal/spline/fancy{dir = 8},/obj/structure/table/reinforced,/obj/item/clothing/gloves/boxing/hologloves,/turf/floor/tiled/brown,/area/template_noop)
"Y" = (/obj/effect/floor_decal/corner/grey/three_quarters{dir = 8},/obj/effect/floor_decal/industrial/boxcorners,/turf/floor/tiled/dark,/area/template_noop)
"Z" = (/obj/effect/floor_decal/spline/fancy{dir = 4},/turf/floor/tiled/dark/rough,/area/template_noop)

(1,1,1) = {"
bKKKKKKKny
VffaaaaffZ
FfTAAAHDfZ
FSgdzjuUIZ
FSgzYJjUIZ
FSgRQwPUIZ
FSgcRPhUIZ
FfiMqqqvfZ
FffCCCCfft
pxNNNNNNNs
"}
