"a" = (/obj/structure/window/reinforced,/obj/structure/bed/chair/red,/obj/effect/floor_decal/industrial/warning,/turf/floor/tiled/dark/rough,/area/template_noop)
"b" = (/obj/effect/floor_decal/corner/green/three_quarters{dir = 4},/turf/floor/tiled/rough,/area/template_noop)
"d" = (/obj/effect/floor_decal/corner/green{dir = 9},/turf/floor/tiled/rough,/area/template_noop)
"e" = (/obj/effect/floor_decal/corner/green{dir = 5},/turf/floor/tiled/rough,/area/template_noop)
"f" = (/obj/effect/floor_decal/corner/green{dir = 6},/turf/floor/tiled/rough,/area/template_noop)
"g" = (/obj/effect/floor_decal/corner/green/three_quarters,/turf/floor/tiled/rough,/area/template_noop)
"h" = (/obj/effect/floor_decal/corner/red/three_quarters{dir = 1},/turf/floor/tiled/rough,/area/template_noop)
"i" = (/obj/item/clothing/head/beanie/green,/obj/item/clothing/head/beanie/green,/obj/structure/table/standard,/turf/floor/tiled/dark/rough,/area/template_noop)
"j" = (/obj/effect/floor_decal/corner/red{dir = 10},/turf/floor/tiled/rough,/area/template_noop)
"k" = (/obj/effect/floor_decal/corner/green/three_quarters{dir = 1},/turf/floor/tiled/rough,/area/template_noop)
"m" = (/obj/machinery/door/window/northright,/obj/effect/floor_decal/industrial/warning{dir = 1},/turf/floor/tiled/dark/rough,/area/template_noop)
"n" = (/obj/effect/floor_decal/corner/red{dir = 6},/turf/floor/tiled/rough,/area/template_noop)
"p" = (/obj/effect/floor_decal/corner/green/three_quarters{dir = 8},/turf/floor/tiled/rough,/area/template_noop)
"r" = (/obj/effect/floor_decal/corner/red{dir = 6},/obj/item/beach_ball/basketball,/turf/floor/tiled/rough,/area/template_noop)
"s" = (/turf/floor/tiled/rough,/area/template_noop)
"t" = (/obj/effect/floor_decal/industrial/warning/corner{dir = 4},/turf/floor/tiled/dark/rough,/area/template_noop)
"u" = (/obj/structure/window/reinforced{dir = 1; health = null},/obj/structure/bed/chair/red{dir = 1},/obj/effect/floor_decal/industrial/warning{dir = 1},/turf/floor/tiled/dark/rough,/area/template_noop)
"v" = (/obj/effect/floor_decal/corner/red{dir = 5},/turf/floor/tiled/rough,/area/template_noop)
"x" = (/obj/effect/floor_decal/corner/red/three_quarters,/turf/floor/tiled/rough,/area/template_noop)
"y" = (/obj/effect/floor_decal/industrial/warning/corner,/turf/floor/tiled/dark/rough,/area/template_noop)
"z" = (/turf/floor/tiled/dark/rough,/area/template_noop)
"A" = (/obj/machinery/door/window/northleft,/obj/effect/floor_decal/industrial/warning{dir = 1},/turf/floor/tiled/dark/rough,/area/template_noop)
"B" = (/obj/item/clothing/head/beanie/red,/obj/item/clothing/head/beanie/red,/obj/structure/table/standard,/turf/floor/tiled/dark/rough,/area/template_noop)
"C" = (/obj/machinery/door/window/southright,/obj/effect/floor_decal/industrial/warning,/turf/floor/tiled/dark/rough,/area/template_noop)
"D" = (/obj/effect/floor_decal/corner/green{dir = 10},/turf/floor/tiled/rough,/area/template_noop)
"F" = (/obj/effect/floor_decal/corner/red{dir = 9},/turf/floor/tiled/rough,/area/template_noop)
"G" = (/obj/structure/window/reinforced{dir = 8},/obj/effect/floor_decal/industrial/warning{dir = 8},/turf/floor/tiled/dark/rough,/area/template_noop)
"I" = (/obj/structure/window/reinforced{dir = 4},/obj/effect/floor_decal/industrial/warning{dir = 4},/turf/floor/tiled/dark/rough,/area/template_noop)
"K" = (/obj/effect/floor_decal/corner/red/three_quarters{dir = 8},/turf/floor/tiled/rough,/area/template_noop)
"L" = (/obj/effect/floor_decal/corner/red/full,/obj/effect/floor_decal/industrial/outline,/obj/structure/hoop{dir = 4},/turf/floor/tiled/rough,/area/template_noop)
"M" = (/obj/effect/floor_decal/corner/red{dir = 1},/turf/floor/tiled/rough,/area/template_noop)
"N" = (/obj/structure/window/reinforced,/obj/structure/bed/chair/green,/obj/effect/floor_decal/industrial/warning,/turf/floor/tiled/dark/rough,/area/template_noop)
"O" = (/obj/structure/window/reinforced{dir = 1; health = null},/obj/structure/bed/chair/green{dir = 1},/obj/effect/floor_decal/industrial/warning{dir = 1},/turf/floor/tiled/dark/rough,/area/template_noop)
"P" = (/obj/effect/floor_decal/corner/red/three_quarters{dir = 4},/turf/floor/tiled/rough,/area/template_noop)
"Q" = (/obj/effect/floor_decal/industrial/warning/corner{dir = 8},/turf/floor/tiled/dark/rough,/area/template_noop)
"R" = (/obj/effect/floor_decal/corner/red{dir = 8},/turf/floor/tiled/rough,/area/template_noop)
"S" = (/obj/effect/floor_decal/corner/green,/turf/floor/tiled/rough,/area/template_noop)
"T" = (/obj/machinery/door/window/southleft,/obj/effect/floor_decal/industrial/warning,/turf/floor/tiled/dark/rough,/area/template_noop)
"U" = (/obj/effect/floor_decal/corner/green{dir = 4},/turf/floor/tiled/rough,/area/template_noop)
"V" = (/obj/effect/floor_decal/industrial/warning/corner{dir = 1},/turf/floor/tiled/dark/rough,/area/template_noop)
"W" = (/obj/effect/floor_decal/corner/green/full,/obj/effect/floor_decal/industrial/outline,/obj/structure/hoop{dir = 8},/turf/floor/tiled/rough,/area/template_noop)

(1,1,1) = {"
zzzzzzzzzz
yaaTaNCNNQ
IKvvhpeekG
IxRsndsSbG
ILFsrdsfWG
IKMsndsUkG
IxjjPgDDbG
tuuAuOmOOV
zzzzzzzzzz
BBBzzzziii
"}
