"a" = (/turf/floor/natural/jungle/sandgrasscorner2,/area/template_noop)
"b" = (/obj/structure/table/standard,/obj/item/glass_extra/lime_slice{pixel_y = 8; pixel_x = -4},/obj/item/glass_extra/orange_slice{pixel_y = 7},/obj/item/reagent_containers/vessel/glass/hurricane{pixel_y = 7},/obj/item/glass_extra/straw{pixel_x = 4},/obj/item/reagent_containers/food/watermelonslice,/turf/floor/natural/jungle/sand,/area/template_noop)
"c" = (/turf/floor/natural/jungle/sand,/area/template_noop)
"f" = (/turf/floor/natural/jungle/water/corner,/area/template_noop)
"i" = (/obj/structure/flora/ausbushes/fernybush,/turf/floor/natural/jungle/sandgrasscorner1,/area/template_noop)
"j" = (/turf/floor/natural/jungle/water/edge{dir = 4},/area/template_noop)
"k" = (/obj/effect/overlay/coconut,/obj/effect/overlay/palmtree_l,/turf/floor/natural/jungle/sand,/area/template_noop)
"l" = (/turf/floor/natural/jungle/sandgrasscorner1{dir = 8},/area/template_noop)
"m" = (/obj/structure/flora/ausbushes/jungleflora/grassa,/turf/floor/natural/jungle/sandgrasscorner2{dir = 8},/area/template_noop)
"o" = (/obj/effect/overlay/palmtree_l,/turf/floor/natural/jungle/sand,/area/template_noop)
"p" = (/obj/item/melee/energy/sword/pirate,/turf/floor/natural/jungle/sandgrasscorner2{dir = 8},/area/template_noop)
"q" = (/obj/structure/bed/chair/teal{dir = 4},/obj/item/clothing/head/pirate,/turf/floor/natural/jungle/sand,/area/template_noop)
"s" = (/turf/floor/natural/jungle/sandgrassedge{dir = 4},/area/template_noop)
"t" = (/obj/structure/flora/ausbushes/jungleflora/bushb,/turf/floor/natural/jungle/sandgrasscorner1,/area/template_noop)
"u" = (/obj/item/clothing/glasses/eyepatch,/turf/floor/natural/jungle/sandgrasscorner2,/area/template_noop)
"x" = (/obj/effect/overlay/palmtree_r,/turf/floor/natural/jungle/sandgrasscorner1,/area/template_noop)
"y" = (/obj/structure/flora/ausbushes/jungleflora/busha,/turf/floor/natural/jungle,/area/template_noop)
"z" = (/obj/item/clothing/suit/pirate,/turf/floor/natural/jungle/sand,/area/template_noop)
"A" = (/obj/item/bikehorn/rubberducky,/turf/floor/natural/jungle/water,/area/template_noop)
"D" = (/obj/item/clothing/head/collectable/paper,/obj/item/clothing/head/collectable/paper{pixel_y = -8; pixel_x = 10},/obj/item/clothing/head/collectable/paper{pixel_y = -12; pixel_x = -5},/turf/floor/natural/jungle/water,/area/template_noop)
"F" = (/obj/item/inflatable_duck,/turf/floor/natural/jungle/water,/area/template_noop)
"H" = (/turf/floor/natural/jungle/water,/area/template_noop)
"I" = (/turf/floor/natural/jungle/sandgrasscorner1{dir = 8},/area/template_noop)
"J" = (/obj/structure/bed/chair/lime{dir = 4},/turf/floor/natural/jungle/sand,/area/template_noop)
"K" = (/obj/item/clothing/glasses/sunglasses,/turf/floor/natural/jungle/sand,/area/template_noop)
"M" = (/obj/item/beach_ball,/turf/floor/natural/jungle/sand,/area/template_noop)
"N" = (/turf/floor/natural/jungle/water/edge{dir = 5},/area/template_noop)
"P" = (/obj/structure/flora/ausbushes/jungleflora/bushb,/obj/item/reagent_containers/food/grown/watermelon,/turf/floor/natural/jungle,/area/template_noop)
"Q" = (/turf/floor/natural/jungle,/area/template_noop)
"R" = (/turf/floor/natural/jungle/water/edge{dir = 6},/area/template_noop)
"T" = (/turf/floor/natural/jungle/water/corner{dir = 8},/area/template_noop)
"V" = (/obj/structure/flora/ausbushes/jungleflora/grassa,/turf/floor/natural/jungle/sandgrasscorner2,/area/template_noop)
"W" = (/obj/item/clothing/under/redcoat,/turf/floor/natural/jungle/sand,/area/template_noop)
"X" = (/obj/structure/flora/ausbushes/fernybush,/turf/floor/natural/jungle/sandgrasscorner2{dir = 8},/area/template_noop)
"Y" = (/obj/effect/overlay/coconut,/turf/floor/natural/jungle/sand,/area/template_noop)
"Z" = (/obj/item/melee/energy/sword/pirate,/turf/floor/natural/jungle/sand,/area/template_noop)

(1,1,1) = {"
yQiVccfRHH
QxuzccjHDH
taZqWfRHHH
accMcjHHHH
ccYbKjFHHH
cocJcjHHHH
XccccjHHHH
sccccTNHHH
lmckccjAHH
PIpcccTNHH
"}
