"a" = (/turf/simulated/floor/holofloor/tiled/dark,/area/template_noop)
"c" = (/obj/machinery/door/window{dir = 1; name = "Green Corner"},/turf/simulated/floor/holofloor/tiled/dark,/area/template_noop)
"i" = (/obj/effect/floor_decal/corner/green{dir = 10},/turf/simulated/floor/holofloor/tiled,/area/template_noop)
"j" = (/obj/effect/floor_decal/corner/blue/three_quarters{dir = 8},/turf/simulated/floor/holofloor/tiled,/area/template_noop)
"k" = (/obj/item/stool/padded,/turf/simulated/floor/holofloor/tiled/dark,/area/template_noop)
"m" = (/obj/effect/floor_decal/corner/green/three_quarters{dir = 4},/turf/simulated/floor/holofloor/tiled,/area/template_noop)
"o" = (/obj/effect/floor_decal/corner/red{dir = 9},/turf/simulated/floor/holofloor/tiled,/area/template_noop)
"s" = (/obj/effect/floor_decal/corner/blue/three_quarters{dir = 1},/turf/simulated/floor/holofloor/tiled,/area/template_noop)
"v" = (/obj/structure/table/standard,/obj/item/clothing/gloves/boxing,/turf/simulated/floor/holofloor/tiled/dark,/area/template_noop)
"w" = (/obj/structure/window/reinforced{dir = 1},/turf/simulated/floor/holofloor/tiled/dark,/area/template_noop)
"y" = (/obj/effect/floor_decal/corner/blue/three_quarters{dir = 4},/turf/simulated/floor/holofloor/tiled,/area/template_noop)
"B" = (/obj/effect/floor_decal/corner/green{dir = 6},/turf/simulated/floor/holofloor/tiled,/area/template_noop)
"D" = (/obj/effect/floor_decal/corner/blue/three_quarters,/turf/simulated/floor/holofloor/tiled,/area/template_noop)
"G" = (/obj/structure/window/reinforced,/turf/simulated/floor/holofloor/tiled/dark,/area/template_noop)
"H" = (/obj/structure/window/reinforced{dir = 4},/turf/simulated/floor/holofloor/tiled/dark,/area/template_noop)
"J" = (/obj/structure/table/standard,/obj/item/clothing/gloves/boxing{icon_state = "boxinggreen"; item_state = "boxinggreen"},/turf/simulated/floor/holofloor/tiled/dark,/area/template_noop)
"K" = (/obj/machinery/door/window{base_state = "right"; dir = 2; icon_state = "right"; name = "Red Corner"},/turf/simulated/floor/holofloor/tiled/dark,/area/template_noop)
"L" = (/obj/effect/floor_decal/corner/red{dir = 5},/turf/simulated/floor/holofloor/tiled,/area/template_noop)
"O" = (/obj/structure/window/reinforced{dir = 8},/turf/simulated/floor/holofloor/tiled/dark,/area/template_noop)
"R" = (/turf/simulated/floor/holofloor/tiled,/area/template_noop)
"X" = (/obj/effect/floor_decal/corner/red/three_quarters{dir = 8},/turf/simulated/floor/holofloor/tiled,/area/template_noop)

(1,1,1) = {"
vvaaaaaaaa
aaaakkkaaa
aaaKGGGaaa
akHXLLROka
akHojsBOka
akHoDyBOka
akHRiimOka
aaawwwcaaa
aaakkkaaaa
aaaaaaaaJJ
"}
