"a" = (/turf/floor/natural/sand,/area/template_noop)
"c" = (/obj/structure/flora/tree/dead/deadtree_2,/obj/structure/flora/ausbushes/sparsegrass,/obj/structure/flora/ausbushes/glowshroom,/turf/floor/natural/sand,/area/template_noop)
"e" = (/obj/structure/flora/ausbushes/fullgrass,/obj/structure/flora/ausbushes/ywflowers,/turf/floor/natural/sand,/area/template_noop)
"l" = (/obj/structure/flora/ausbushes/sparsegrass,/turf/floor/natural/sand,/area/template_noop)
"m" = (/obj/structure/flora/ausbushes/fullgrass,/turf/floor/natural/sand,/area/template_noop)
"n" = (/obj/structure/flora/ausbushes/fernybush,/turf/floor/natural/sand,/area/template_noop)
"o" = (/obj/structure/flora/tree/green/tree9,/turf/floor/natural/sand,/area/template_noop)
"p" = (/obj/structure/sink/puddle,/turf/floor/natural/sand,/area/template_noop)
"y" = (/obj/structure/flora/ausbushes/lavendergrass,/obj/structure/flora/ausbushes/ppflowers,/turf/floor/natural/sand,/area/template_noop)
"A" = (/obj/structure/flora/ausbushes/lavendergrass,/turf/floor/natural/sand,/area/template_noop)
"E" = (/obj/structure/flora/ausbushes/sparsegrass,/obj/structure/flora/ausbushes/lavendergrass,/turf/floor/natural/sand,/area/template_noop)
"I" = (/obj/structure/flora/ausbushes/fullgrass,/obj/structure/gravemarker/cross,/obj/structure/flora/tree/dead/deadtree_3,/turf/floor/natural/sand,/area/template_noop)
"J" = (/obj/item/clothing/suit/poncho/colored,/obj/item/clothing/head/sombrero,/turf/floor/natural/sand,/area/template_noop)
"K" = (/obj/structure/flora/ausbushes/fullgrass,/obj/item/device/synthesized_instrument/guitar,/turf/floor/natural/sand,/area/template_noop)
"Q" = (/obj/structure/flora/ausbushes/sparsegrass,/obj/structure/flora/ausbushes/brflowers,/turf/floor/natural/sand,/area/template_noop)
"S" = (/turf/floor/sand_floor,/area/template_noop)
"T" = (/obj/structure/flora/ausbushes/reedbush,/turf/floor/natural/sand,/area/template_noop)
"V" = (/obj/structure/flora/tree/green/tree8,/turf/floor/natural/sand,/area/template_noop)
"Y" = (/obj/structure/flora/ausbushes/sparsegrass,/obj/structure/flora/tree/dead/deadtree_4,/turf/floor/natural/sand,/area/template_noop)
"Z" = (/obj/structure/flora/tree/dead/deadtree_6,/turf/floor/natural/sand,/area/template_noop)

(1,1,1) = {"
aaaSSSSaaa
eIaaaSSSSa
alAaaaSSca
SaaaJKonTS
SaaAlnpaaS
SSYyaaaaaS
SaaEaaaaSS
aaaZmaaQVa
alaaaaaaaa
aaaSSSSaaa
"}
