"a" = (/obj/effect/floor_decal/industrial/warning,/turf/floor/tiled/dark/rough,/area/template_noop)
"d" = (/obj/effect/floor_decal/corner/red{dir = 10},/obj/effect/floor_decal/industrial/warning{dir = 8},/turf/floor/tiled/dark/rough,/area/template_noop)
"f" = (/obj/effect/floor_decal/corner/blue{dir = 6},/obj/effect/floor_decal/industrial/warning{dir = 1},/turf/floor/tiled/dark/rough,/area/template_noop)
"l" = (/obj/effect/floor_decal/corner/blue/diagonal,/obj/effect/floor_decal/industrial/warning{dir = 1},/turf/floor/tiled/dark/rough,/area/template_noop)
"n" = (/obj/structure/closet/lasertag/red,/obj/effect/floor_decal/industrial/hatch/red,/turf/floor/tiled/dark/rough,/area/template_noop)
"q" = (/obj/effect/floor_decal/corner/blue{dir = 5},/turf/floor/tiled/dark/rough,/area/template_noop)
"t" = (/obj/effect/floor_decal/industrial/warning{dir = 1},/turf/floor/tiled/dark/rough,/area/template_noop)
"u" = (/obj/effect/floor_decal/corner/red/diagonal,/obj/effect/floor_decal/industrial/warning{dir = 8},/turf/floor/tiled/dark/rough,/area/template_noop)
"v" = (/obj/effect/floor_decal/corner/red{dir = 9},/obj/effect/floor_decal/industrial/warning,/turf/floor/tiled/dark/rough,/area/template_noop)
"w" = (/obj/effect/floor_decal/corner/red/diagonal,/turf/floor/tiled/dark/rough,/area/template_noop)
"y" = (/obj/effect/floor_decal/corner/red{dir = 10},/turf/floor/tiled/dark/rough,/area/template_noop)
"A" = (/obj/structure/closet/lasertag/blue,/obj/effect/floor_decal/industrial/hatch/blue,/turf/floor/tiled/dark/rough,/area/template_noop)
"B" = (/obj/effect/floor_decal/corner/purple/mono,/turf/floor/tiled/dark/mono,/area/template_noop)
"E" = (/obj/effect/floor_decal/corner/blue{dir = 6},/turf/floor/tiled/dark/rough,/area/template_noop)
"F" = (/obj/effect/floor_decal/corner/blue/diagonal,/obj/effect/floor_decal/industrial/warning{dir = 4},/turf/floor/tiled/dark/rough,/area/template_noop)
"G" = (/obj/effect/floor_decal/industrial/warning{dir = 8},/turf/floor/tiled/dark/rough,/area/template_noop)
"H" = (/turf/floor/tiled/dark/rough,/area/template_noop)
"I" = (/obj/effect/floor_decal/industrial/warning{dir = 4},/turf/floor/tiled/dark/rough,/area/template_noop)
"L" = (/obj/effect/floor_decal/corner/red{dir = 9},/turf/floor/tiled/dark/rough,/area/template_noop)
"O" = (/obj/effect/floor_decal/corner/blue/mono,/turf/floor/tiled/dark/mono,/area/template_noop)
"P" = (/obj/effect/floor_decal/corner/red/mono,/turf/floor/tiled/dark/mono,/area/template_noop)
"U" = (/obj/effect/floor_decal/corner/blue/diagonal,/turf/floor/tiled/dark/rough,/area/template_noop)
"W" = (/obj/effect/floor_decal/corner/red/diagonal,/obj/effect/floor_decal/industrial/warning,/turf/floor/tiled/dark/rough,/area/template_noop)
"Y" = (/obj/effect/floor_decal/corner/blue{dir = 5},/obj/effect/floor_decal/industrial/warning{dir = 4},/turf/floor/tiled/dark/rough,/area/template_noop)
"Z" = (/obj/structure/girder/cult,/obj/structure/window/reinforced/tinted/full,/turf/floor/tiled/brown,/area/template_noop)

(1,1,1) = {"
BttttflllA
GZZHOEUZUF
GZHHHZUUUF
GZHZqZZZqY
GHHZPOEHOI
GPHLPOZHHI
dyZZZyZHZI
uwwwZHHHZI
uwZwLPHZZI
nWWWvaaaaB
"}
