"a" = (/turf/floor/reinforced,/area/template_noop)
"K" = (/obj/effect/holodeck_effect/carp,/turf/floor/reinforced,/area/template_noop)

(1,1,1) = {"
aaaaaaaaaa
aKaaaaaaKa
aaaaaaaaaa
aaaKaaKaaa
aaaaaaaaaa
aaaaaaaaaa
aaaKaaKaaa
aaaaaaaaaa
aKaaaaaaKa
aaaaaaaaaa
"}
