"a" = (/obj/structure/flora/ausbushes/brflowers,/turf/simulated/floor/holofloor/grass,/area/template_noop)
"c" = (/obj/structure/flora/ausbushes/ywflowers,/obj/effect/floor_decal/spline/fancy/wood{dir = 8},/turf/simulated/floor/holofloor/grass,/area/template_noop)
"g" = (/obj/structure/flora/ausbushes/brflowers,/obj/effect/floor_decal/spline/fancy/wood{dir = 4},/turf/simulated/floor/holofloor/grass,/area/template_noop)
"h" = (/obj/structure/flora/ausbushes/sparsegrass,/turf/simulated/floor/holofloor/grass,/area/template_noop)
"i" = (/obj/structure/flora/ausbushes/ywflowers,/obj/effect/floor_decal/spline/fancy/wood/corner{dir = 8},/turf/simulated/floor/holofloor/grass,/area/template_noop)
"p" = (/obj/structure/flora/ausbushes/brflowers,/obj/effect/floor_decal/spline/fancy/wood/corner,/turf/simulated/floor/holofloor/grass,/area/template_noop)
"r" = (/obj/structure/table/woodentable,/turf/simulated/floor/holofloor/desert,/area/template_noop)
"s" = (/obj/structure/flora/ausbushes/ywflowers,/obj/effect/floor_decal/spline/fancy/wood,/turf/simulated/floor/holofloor/grass,/area/template_noop)
"A" = (/obj/structure/flora/ausbushes/brflowers,/obj/effect/floor_decal/spline/fancy/wood,/turf/simulated/floor/holofloor/grass,/area/template_noop)
"E" = (/obj/effect/decal/cleanable/dirt,/turf/simulated/floor/holofloor/desert,/area/template_noop)
"H" = (/obj/structure/flora/ausbushes/brflowers,/obj/effect/floor_decal/spline/fancy/wood{dir = 9},/turf/simulated/floor/holofloor/grass,/area/template_noop)
"I" = (/obj/structure/flora/ausbushes/ywflowers,/obj/effect/floor_decal/spline/fancy/wood{dir = 5},/turf/simulated/floor/holofloor/grass,/area/template_noop)
"L" = (/obj/structure/flora/ausbushes/ywflowers,/obj/effect/floor_decal/spline/fancy/wood/corner{dir = 4},/turf/simulated/floor/holofloor/grass,/area/template_noop)
"O" = (/obj/structure/flora/ausbushes/brflowers,/obj/effect/floor_decal/spline/fancy/wood/corner{dir = 1},/turf/simulated/floor/holofloor/grass,/area/template_noop)
"S" = (/obj/structure/flora/ausbushes/fullgrass,/turf/simulated/floor/holofloor/grass,/area/template_noop)
"W" = (/obj/structure/flora/ausbushes/ywflowers,/turf/simulated/floor/holofloor/grass,/area/template_noop)
"X" = (/obj/effect/decal/cleanable/dirt,/obj/item/stool/padded,/turf/simulated/floor/holofloor/desert,/area/template_noop)
"Y" = (/obj/structure/flora/ausbushes/ywflowers,/obj/effect/floor_decal/spline/fancy/wood{dir = 4},/turf/simulated/floor/holofloor/grass,/area/template_noop)
"Z" = (/obj/structure/flora/ausbushes/brflowers,/obj/effect/floor_decal/spline/fancy/wood{dir = 8},/turf/simulated/floor/holofloor/grass,/area/template_noop)

(1,1,1) = {"
SWaWaWaWaS
SaWaWaWaWh
SWpsAsAiah
haYEEEEZWS
hWgXrrXcaS
SWgXrrXcah
SaYEEEEZWS
hWOIEEHLah
SaWgEEcaaS
SWaYEEcaWS
"}
