"a" = (/turf/simulated/floor/trim/carpet,/area/template_noop)
"b" = (/obj/structure/bed/chair/red{dir = 1},/obj/structure/window/reinforced{dir = 4},/turf/simulated/floor/trim/wood,/area/template_noop)
"c" = (/obj/structure/table/woodentable,/obj/item/reagent_containers/food/donut/chaos,/turf/simulated/floor/trim/carpet,/area/template_noop)
"e" = (/obj/structure/bed/chair/purp{dir = 1},/obj/structure/window/reinforced{dir = 4},/obj/effect/floor_decal/siding/wood,/turf/simulated/floor/trim/wood,/area/template_noop)
"f" = (/obj/structure/table/woodentable,/obj/structure/window/reinforced,/obj/item/clothing/head/tinfoil,/turf/simulated/floor/trim/carpet,/area/template_noop)
"g" = (/obj/structure/table/woodentable,/obj/effect/floor_decal/siding/wood{dir = 1},/obj/item/device/flashlight/lamp/brown{pixel_x = -6},/turf/simulated/floor/trim/wood,/area/template_noop)
"h" = (/obj/structure/table/woodentable,/obj/item/reagent_containers/food/donut/cherryjelly,/obj/structure/window/reinforced,/turf/simulated/floor/trim/carpet,/area/template_noop)
"i" = (/obj/structure/table/woodentable,/obj/effect/floor_decal/siding/wood{dir = 1},/obj/item/reagent_containers/food/donut/chaos,/turf/simulated/floor/trim/wood,/area/template_noop)
"j" = (/obj/structure/bed/chair/purp{dir = 8},/obj/structure/window/reinforced,/turf/simulated/floor/trim/carpet/purple,/area/template_noop)
"k" = (/obj/structure/bed/chair/purp{dir = 8},/turf/simulated/floor/trim/carpet/purple,/area/template_noop)
"l" = (/obj/structure/table/woodentable,/obj/structure/window/reinforced,/obj/structure/window/reinforced{dir = 4},/turf/simulated/floor/trim/carpet,/area/template_noop)
"m" = (/obj/structure/table/woodentable,/obj/item/reagent_containers/food/donut/chaos,/turf/simulated/floor/trim/carpet/purple,/area/template_noop)
"n" = (/obj/structure/bed/chair/purp{dir = 1},/obj/effect/floor_decal/siding/wood,/turf/simulated/floor/trim/wood,/area/template_noop)
"p" = (/obj/structure/table/woodentable,/obj/structure/window/reinforced,/obj/structure/window/reinforced{dir = 8},/turf/simulated/floor/trim/carpet,/area/template_noop)
"s" = (/obj/structure/table/woodentable,/obj/item/device/flashlight/lamp/brown{pixel_x = -6},/turf/simulated/floor/trim/carpet/purple,/area/template_noop)
"t" = (/turf/simulated/floor/trim/wood,/area/template_noop)
"u" = (/obj/structure/bed/chair/purp{dir = 1},/turf/simulated/floor/trim/wood,/area/template_noop)
"v" = (/obj/structure/table/woodentable,/obj/structure/window/reinforced{dir = 4},/obj/effect/floor_decal/siding/wood{dir = 1},/turf/simulated/floor/trim/wood,/area/template_noop)
"w" = (/obj/structure/window/reinforced{dir = 8},/obj/structure/window/reinforced{dir = 4},/obj/structure/bed/chair/comfy/red,/obj/machinery/door/window/northleft,/obj/structure/window/reinforced,/turf/simulated/floor/trim/carpet,/area/template_noop)
"x" = (/obj/structure/table/woodentable,/obj/structure/window/reinforced,/turf/simulated/floor/trim/carpet/purple,/area/template_noop)
"y" = (/obj/structure/table/woodentable,/obj/item/device/flashlight/lamp/brown{pixel_x = -6},/obj/structure/window/reinforced,/turf/simulated/floor/trim/carpet,/area/template_noop)
"z" = (/obj/structure/table/woodentable,/obj/structure/window/reinforced{dir = 8},/turf/simulated/floor/trim/carpet,/area/template_noop)
"A" = (/obj/structure/table/woodentable,/obj/structure/window/reinforced,/turf/simulated/floor/trim/carpet,/area/template_noop)
"B" = (/obj/structure/table/woodentable,/obj/item/storage/box/donut/empty,/obj/structure/window/reinforced{dir = 4},/obj/structure/window/reinforced{dir = 1; health = 1e+006},/turf/simulated/floor/trim/carpet,/area/template_noop)
"C" = (/obj/structure/table/woodentable,/obj/effect/floor_decal/siding/wood{dir = 1},/obj/item/reagent_containers/food/donut/cherryjelly,/turf/simulated/floor/trim/wood,/area/template_noop)
"F" = (/obj/structure/table/woodentable,/obj/item/clothing/suit/judgerobe,/obj/item/clothing/head/philosopher_wig,/turf/simulated/floor/trim/carpet,/area/template_noop)
"G" = (/obj/structure/table/woodentable,/obj/item/book/wiki/nt_regs{pixel_y = 9},/obj/structure/window/reinforced{dir = 1; health = 1e+006},/turf/simulated/floor/trim/carpet,/area/template_noop)
"H" = (/obj/structure/window/reinforced{dir = 4},/turf/simulated/floor/trim/wood,/area/template_noop)
"I" = (/obj/random/pottedplant,/obj/effect/floor_decal/siding/wood/end,/obj/effect/floor_decal/siding/wood{dir = 1},/obj/effect/floor_decal/siding/wood/corner{dir = 1},/obj/effect/floor_decal/siding/wood/corner{dir = 4},/turf/simulated/floor/trim/wood,/area/template_noop)
"J" = (/obj/structure/window/reinforced{dir = 4},/obj/structure/window/reinforced{dir = 8},/obj/structure/bed/chair/comfy/blue,/obj/machinery/door/window/northleft,/obj/structure/window/reinforced,/turf/simulated/floor/trim/carpet,/area/template_noop)
"L" = (/obj/structure/bed/chair/red{dir = 1},/turf/simulated/floor/trim/wood,/area/template_noop)
"M" = (/obj/structure/table/woodentable,/obj/item/book/wiki/nt_regs{pixel_y = 9},/turf/simulated/floor/trim/carpet/purple,/area/template_noop)
"N" = (/obj/effect/floor_decal/siding/wood{dir = 8},/turf/simulated/floor/trim/wood,/area/template_noop)
"P" = (/obj/structure/table/woodentable,/turf/simulated/floor/trim/carpet/purple,/area/template_noop)
"Q" = (/turf/simulated/floor/trim/lino,/area/template_noop)
"R" = (/obj/structure/window/reinforced{dir = 1; health = 1e+006},/turf/simulated/floor/trim/carpet,/area/template_noop)
"T" = (/obj/effect/floor_decal/siding/wood{dir = 1},/turf/simulated/floor/trim/wood,/area/template_noop)
"U" = (/obj/structure/bed/chair/comfy/purp,/turf/simulated/floor/trim/carpet,/area/template_noop)
"V" = (/obj/structure/bed/chair/purp{dir = 1},/obj/structure/window/reinforced{dir = 4},/turf/simulated/floor/trim/wood,/area/template_noop)
"W" = (/obj/structure/table/woodentable,/obj/structure/window/reinforced{dir = 8},/obj/structure/window/reinforced{dir = 1; health = 1e+006},/turf/simulated/floor/trim/carpet,/area/template_noop)
"Y" = (/obj/structure/bed/chair/blue{dir = 1},/turf/simulated/floor/trim/wood,/area/template_noop)

(1,1,1) = {"
QQQQQQQQQQ
QWRaaaaGBQ
QzacUFaaaQ
QpJyAhwflQ
QIgiTCvskQ
QNYYtLbMkQ
QNttttHmkQ
QNuuuuVPkQ
QInnnnexjQ
QQQQQQQQQQ
"}
