"a" = (/obj/structure/table/holotable,/obj/effect/floor_decal/corner/red/three_quarters{dir = 8},/turf/simulated/floor/holofloor/tiled,/area/template_noop)
"e" = (/obj/machinery/door/window/holowindoor{dir = 1; name = "Red Team"},/turf/simulated/floor/holofloor/tiled/dark,/area/template_noop)
"h" = (/obj/structure/table/holotable,/obj/effect/floor_decal/corner/green/three_quarters{dir = 1},/turf/simulated/floor/holofloor/tiled,/area/template_noop)
"i" = (/obj/effect/floor_decal/corner/red{dir = 10},/turf/simulated/floor/holofloor/tiled,/area/template_noop)
"m" = (/obj/structure/window/reinforced/holowindow/disappearing{dir = 8},/obj/effect/floor_decal/corner/green{dir = 9},/turf/simulated/floor/holofloor/tiled,/area/template_noop)
"o" = (/obj/structure/table/holotable,/obj/item/clothing/head/helmet/thunderdome,/obj/item/clothing/suit/armor/tdome/green,/obj/item/clothing/under/color/green,/obj/item/holo/esword/green,/obj/effect/floor_decal/corner/green{dir = 6},/turf/simulated/floor/holofloor/tiled,/area/template_noop)
"q" = (/obj/structure/holostool,/turf/simulated/floor/holofloor/tiled,/area/template_noop)
"x" = (/obj/structure/window/reinforced/holowindow/disappearing{dir = 4},/obj/effect/floor_decal/corner/red{dir = 6},/turf/simulated/floor/holofloor/tiled,/area/template_noop)
"C" = (/obj/structure/table/holotable,/obj/item/clothing/head/helmet/thunderdome,/obj/item/clothing/suit/armor/tdome/red,/obj/item/clothing/under/color/red,/obj/item/holo/esword/red,/obj/effect/floor_decal/corner/red{dir = 9},/turf/simulated/floor/holofloor/tiled,/area/template_noop)
"D" = (/obj/effect/floor_decal/corner/red/three_quarters{dir = 4},/obj/structure/window/reinforced/holowindow/disappearing{dir = 4},/turf/simulated/floor/holofloor/tiled,/area/template_noop)
"F" = (/obj/effect/floor_decal/corner/green{dir = 5},/turf/simulated/floor/holofloor/tiled,/area/template_noop)
"H" = (/obj/structure/table/holotable,/obj/machinery/readybutton,/obj/effect/floor_decal/corner/green/three_quarters{dir = 4},/turf/simulated/floor/holofloor/tiled,/area/template_noop)
"M" = (/obj/effect/floor_decal/corner/green/three_quarters{dir = 8},/obj/structure/window/reinforced/holowindow/disappearing{dir = 8},/turf/simulated/floor/holofloor/tiled,/area/template_noop)
"N" = (/obj/effect/floor_decal/corner/green/three_quarters,/obj/structure/window/reinforced/holowindow/disappearing{dir = 8},/turf/simulated/floor/holofloor/tiled,/area/template_noop)
"O" = (/turf/simulated/floor/holofloor/tiled,/area/template_noop)
"Q" = (/obj/effect/floor_decal/corner/green{dir = 10},/turf/simulated/floor/holofloor/tiled,/area/template_noop)
"S" = (/obj/structure/holostool,/obj/structure/window/reinforced/holowindow{dir = 1},/turf/simulated/floor/holofloor/tiled,/area/template_noop)
"T" = (/obj/effect/floor_decal/corner/red/three_quarters{dir = 1},/obj/structure/window/reinforced/holowindow/disappearing{dir = 4},/turf/simulated/floor/holofloor/tiled,/area/template_noop)
"U" = (/turf/simulated/floor/holofloor/tiled/dark,/area/template_noop)
"V" = (/obj/machinery/door/window/holowindoor{base_state = "right"; dir = 1; icon_state = "right"; name = "Green Team"},/turf/simulated/floor/holofloor/tiled/dark,/area/template_noop)
"Y" = (/obj/effect/floor_decal/corner/red{dir = 5},/turf/simulated/floor/holofloor/tiled,/area/template_noop)
"Z" = (/obj/structure/table/holotable,/obj/machinery/readybutton,/obj/effect/floor_decal/corner/red/three_quarters,/turf/simulated/floor/holofloor/tiled,/area/template_noop)

(1,1,1) = {"
aYYYTMFFFh
COOOxmOOOo
COOOxmOOOo
COOOxmOOOo
COOOxmOOOo
COOOxmOOOo
ZiiiDNQQQH
SSVSSSSeSS
qqUqqqqUqq
UUUUUUUUUU
"}
