"a" = (/obj/structure/railing/steel{dir = 4},/obj/effect/floor_decal/spline/fancy{dir = 4},/turf/floor/tiled/dark/rough,/area/template_noop)
"b" = (/obj/structure/table/steel,/obj/item/clothing/head/cakehat,/obj/effect/floor_decal/spline/plain{dir = 1},/turf/floor/tiled/dark/rough,/area/template_noop)
"c" = (/obj/structure/railing/steel,/obj/effect/floor_decal/spline/fancy,/turf/floor/tiled/dark/rough,/area/template_noop)
"e" = (/obj/effect/floor_decal/spline/fancy,/turf/floor/tiled/dark/mono,/area/template_noop)
"f" = (/obj/structure/railing/steel{dir = 1},/obj/effect/floor_decal/spline/fancy{dir = 1},/turf/floor/tiled/dark/mono,/area/template_noop)
"h" = (/obj/effect/floor_decal/spline/plain{dir = 8},/turf/floor/tiled/dark/rough,/area/template_noop)
"k" = (/obj/effect/floor_decal/spline/plain{dir = 1},/turf/floor/tiled/dark/mono,/area/template_noop)
"l" = (/obj/effect/floor_decal/spline/plain{dir = 8},/turf/floor/tiled/dark/mono,/area/template_noop)
"m" = (/obj/effect/floor_decal/spline/fancy/corner,/turf/floor/tiled/dark/rough,/area/template_noop)
"n" = (/obj/structure/railing/steel{dir = 1},/obj/effect/floor_decal/spline/fancy{dir = 1},/turf/floor/tiled/dark/rough,/area/template_noop)
"o" = (/obj/effect/floor_decal/spline/fancy{dir = 1},/obj/structure/railing/steel{dir = 1},/turf/floor/tiled/dark/rough,/area/template_noop)
"p" = (/obj/structure/table/steel,/obj/item/clothing/head/crown,/obj/effect/floor_decal/spline/plain{dir = 10},/turf/floor/tiled/dark/mono,/area/template_noop)
"t" = (/obj/structure/railing/steel{dir = 8},/obj/effect/floor_decal/spline/fancy{dir = 8},/turf/floor/tiled/dark/rough,/area/template_noop)
"v" = (/obj/effect/floor_decal/spline/fancy{dir = 1},/obj/structure/railing/steel{dir = 1},/turf/floor/tiled/dark/mono,/area/template_noop)
"w" = (/obj/effect/floor_decal/spline/fancy{dir = 8},/obj/structure/railing/steel{dir = 8},/turf/floor/tiled/dark/mono,/area/template_noop)
"x" = (/obj/effect/floor_decal/spline/plain,/turf/floor/tiled/dark/mono,/area/template_noop)
"y" = (/obj/effect/floor_decal/spline/plain{dir = 4},/turf/floor/tiled/dark/mono,/area/template_noop)
"A" = (/obj/effect/floor_decal/spline/plain,/obj/structure/table/steel,/obj/item/clothing/head/beaverhat,/obj/item/clothing/head/tiara,/turf/floor/tiled/dark/mono,/area/template_noop)
"B" = (/obj/effect/floor_decal/spline/fancy{dir = 4},/obj/structure/railing/steel{dir = 4},/turf/floor/tiled/dark/mono,/area/template_noop)
"C" = (/obj/structure/railing/steel,/obj/effect/floor_decal/spline/fancy,/turf/floor/tiled/dark/mono,/area/template_noop)
"D" = (/obj/effect/floor_decal/spline/plain{dir = 4},/obj/structure/table/steel,/turf/floor/tiled/dark/rough,/area/template_noop)
"E" = (/obj/structure/table/steel,/obj/item/clothing/mask/uwu,/obj/item/clothing/head/samura_hat,/obj/effect/floor_decal/spline/plain{dir = 6},/turf/floor/tiled/dark/mono,/area/template_noop)
"H" = (/obj/effect/floor_decal/spline/fancy{dir = 1},/turf/floor/tiled/dark/rough,/area/template_noop)
"I" = (/obj/effect/floor_decal/spline/fancy/corner{dir = 8},/turf/floor/tiled/dark/rough,/area/template_noop)
"J" = (/obj/effect/floor_decal/spline/plain{dir = 1},/obj/structure/table/steel,/obj/item/clothing/head/agua_helmet,/obj/item/clothing/head/bearpelt,/turf/floor/tiled/dark/rough,/area/template_noop)
"K" = (/obj/effect/floor_decal/spline/plain,/turf/floor/tiled/dark/rough,/area/template_noop)
"L" = (/obj/structure/table/steel,/obj/item/clothing/head/justice,/obj/item/clothing/head/justice/blue,/obj/item/clothing/head/justice/green,/obj/item/clothing/head/justice/pink,/obj/item/clothing/head/justice/yellow,/obj/effect/floor_decal/spline/plain{dir = 9},/turf/floor/tiled/dark/mono,/area/template_noop)
"M" = (/obj/structure/table/steel,/obj/item/clothing/head/antenna,/obj/item/clothing/head/richard,/obj/effect/floor_decal/spline/plain{dir = 5},/turf/floor/tiled/dark/mono,/area/template_noop)
"N" = (/obj/effect/floor_decal/spline/fancy{dir = 8},/turf/floor/tiled/dark/mono,/area/template_noop)
"O" = (/obj/effect/floor_decal/spline/fancy{dir = 4},/turf/floor/tiled/dark/mono,/area/template_noop)
"P" = (/obj/structure/table/steel,/obj/item/clothing/head/kitty,/obj/effect/floor_decal/spline/plain,/turf/floor/tiled/dark/mono,/area/template_noop)
"R" = (/obj/effect/floor_decal/spline/plain{dir = 8},/obj/structure/table/steel,/turf/floor/tiled/dark/mono,/area/template_noop)
"T" = (/obj/effect/floor_decal/spline/plain{dir = 4},/turf/floor/tiled/dark/rough,/area/template_noop)
"U" = (/obj/effect/floor_decal/spline/fancy/corner{dir = 1},/turf/floor/tiled/dark/rough,/area/template_noop)
"W" = (/obj/effect/floor_decal/spline/fancy/corner{dir = 4},/turf/floor/tiled/dark/rough,/area/template_noop)
"Y" = (/obj/machinery/floor_light/prebuilt,/turf/floor/grid,/area/template_noop)
"Z" = (/obj/effect/floor_decal/spline/plain{dir = 1},/turf/floor/tiled/dark/rough,/area/template_noop)

(1,1,1) = {"
LbZZZkkkJM
RmcCeeccIT
haYYYYYYty
hBYYYYYYty
hOYYYYYYNy
hOYYYYYYNT
lBYYYYYYwy
laYYYYYYtT
hUnoHHvfWD
pAKxxKKKPE
"}
