"b" = (/turf/simulated/floor/holospace,/area/template_noop)
"A" = (/obj/effect/holodeck_effect/carp/random,/turf/simulated/floor/holospace,/area/template_noop)

(1,1,1) = {"
bbbbbbbbbb
bbbAbbbbAb
bbbbbbbbbb
bAbbbbAbbb
bbbbbbbbbb
bbbbbbbbbb
bbbAbbbbAb
bbbbbbbbbb
bAbbbbAbbb
bbbbbbbbbb
"}
