//MAP CONVERTED BY dmm2tgm.py THIS HEADER COMMENT PREVENTS RECONVERSION, DO NOT REMOVE
"a" = (
/turf/template_noop,
/area/template_noop)
"c" = (
/turf/simulated/mineral,
/area/ruin/unpowered)
"d" = (
/turf/simulated/mineral/random/high_chance,
/area/ruin/unpowered)

(1,1,1) = {"
a
a
a
a
a
a
a
a
a
a
a
a
a
a
a
a
a
a
a
a
"}
(2,1,1) = {"
a
a
a
a
a
a
a
a
a
a
a
a
a
a
a
a
a
a
a
a
"}
(3,1,1) = {"
a
a
a
a
a
a
a
a
a
a
a
a
a
a
a
a
a
a
a
a
"}
(4,1,1) = {"
a
a
a
a
a
a
a
a
a
a
a
a
a
a
a
a
a
a
a
a
"}
(5,1,1) = {"
a
a
a
a
a
a
c
c
c
c
a
a
a
a
a
a
a
a
a
a
"}
(6,1,1) = {"
a
a
a
a
a
a
c
c
c
c
d
d
d
d
d
a
a
a
a
a
"}
(7,1,1) = {"
a
a
a
a
a
c
c
c
c
c
d
d
d
d
d
a
a
a
a
a
"}
(8,1,1) = {"
a
a
a
a
c
c
c
c
d
c
c
c
c
c
c
a
a
a
a
a
"}
(9,1,1) = {"
a
a
a
a
a
c
c
c
d
c
c
c
c
d
d
d
c
a
a
a
"}
(10,1,1) = {"
a
a
a
a
a
a
c
c
d
d
c
c
d
d
c
c
c
a
a
a
"}
(11,1,1) = {"
a
a
a
a
a
a
c
c
c
d
d
d
d
d
c
c
c
a
a
a
"}
(12,1,1) = {"
a
a
a
a
a
a
d
d
c
d
d
d
d
c
c
c
d
c
a
a
"}
(13,1,1) = {"
a
a
a
a
a
a
d
d
d
c
c
c
c
c
c
c
c
c
a
a
"}
(14,1,1) = {"
a
a
a
a
a
a
a
a
a
c
c
c
c
c
c
d
c
c
c
a
"}
(15,1,1) = {"
a
a
a
a
a
a
a
a
a
c
d
c
c
d
d
d
c
c
c
a
"}
(16,1,1) = {"
a
a
a
a
a
a
a
a
a
a
a
c
c
d
d
d
a
a
a
a
"}
(17,1,1) = {"
a
a
a
a
a
a
a
a
a
a
a
a
a
a
a
a
a
a
a
a
"}
(18,1,1) = {"
a
a
a
a
a
a
a
a
a
a
a
a
a
a
a
a
a
a
a
a
"}
(19,1,1) = {"
a
a
a
a
a
a
a
a
a
a
a
a
a
a
a
a
a
a
a
a
"}
(20,1,1) = {"
a
a
a
a
a
a
a
a
a
a
a
a
a
a
a
a
a
a
a
a
"}
