//MAP CONVERTED BY dmm2tgm.py THIS HEADER COMMENT PREVENTS RECONVERSION, DO NOT REMOVE
"a" = (
/turf/template_noop,
/area/template_noop)
"b" = (
/turf/template_noop,
/area/ruin/unpowered)
"c" = (
/turf/simulated/mineral,
/area/ruin/unpowered)
"d" = (
/turf/simulated/mineral/random/high_chance,
/area/ruin/unpowered)
"e" = (
/obj/item/remains/human,
/turf/template_noop,
/area/ruin/unpowered)
"f" = (
/obj/item/pickaxe/diamond,
/turf/template_noop,
/area/ruin/unpowered)

(1,1,1) = {"
a
a
a
a
a
a
a
a
a
a
a
c
c
c
c
a
a
a
a
a
"}
(2,1,1) = {"
a
a
a
a
a
a
a
a
a
a
a
d
d
c
c
c
c
c
a
a
"}
(3,1,1) = {"
a
a
a
a
a
a
a
a
a
a
a
d
d
c
c
d
d
d
a
a
"}
(4,1,1) = {"
a
a
a
a
a
a
c
c
a
a
c
d
d
c
c
d
d
d
a
a
"}
(5,1,1) = {"
a
a
a
a
c
c
c
c
c
c
c
c
c
c
c
d
d
d
c
a
"}
(6,1,1) = {"
a
a
a
a
c
c
c
c
c
c
c
c
b
c
c
c
c
c
a
a
"}
(7,1,1) = {"
a
a
a
a
a
a
c
d
c
c
b
b
b
b
c
c
c
c
a
a
"}
(8,1,1) = {"
a
a
a
a
a
c
c
c
c
b
b
b
f
b
b
c
c
a
a
a
"}
(9,1,1) = {"
a
a
a
a
a
c
c
c
c
b
b
e
b
b
b
c
c
c
a
a
"}
(10,1,1) = {"
a
a
a
a
a
c
c
b
b
b
b
b
b
b
c
c
c
c
c
a
"}
(11,1,1) = {"
a
a
a
a
a
c
c
c
c
c
b
b
c
c
c
c
d
d
a
a
"}
(12,1,1) = {"
a
a
a
a
a
d
d
c
c
c
c
c
c
c
c
c
d
d
a
a
"}
(13,1,1) = {"
a
a
a
a
a
d
d
c
c
c
d
c
c
c
c
c
c
a
a
a
"}
(14,1,1) = {"
a
a
a
a
a
d
d
c
c
c
c
c
c
c
c
a
a
a
a
a
"}
(15,1,1) = {"
a
a
a
a
a
c
c
c
c
c
c
c
c
c
c
a
a
a
a
a
"}
(16,1,1) = {"
a
a
a
a
a
a
a
c
c
c
c
c
c
a
a
a
a
a
a
a
"}
(17,1,1) = {"
a
a
a
a
a
a
a
c
c
d
d
c
c
a
a
a
a
a
a
a
"}
(18,1,1) = {"
a
a
a
a
a
a
a
a
c
d
d
a
a
a
a
a
a
a
a
a
"}
(19,1,1) = {"
a
a
a
a
a
a
a
a
a
a
a
a
a
a
a
a
a
a
a
a
"}
(20,1,1) = {"
a
a
a
a
a
a
a
a
a
a
a
a
a
a
a
a
a
a
a
a
"}
