//MAP CONVERTED BY dmm2tgm.py THIS HEADER COMMENT PREVENTS RECONVERSION, DO NOT REMOVE
"a" = (
/turf/template_noop,
/area/template_noop)
"b" = (
/turf/simulated/mineral,
/area/ruin/unpowered)
"c" = (
/turf/simulated/mineral/random/high_chance,
/area/ruin/unpowered)
"f" = (
/turf/simulated/floor/plating,
/area/ruin/unpowered)
"g" = (
/obj/item/paper{
	info = "Extraction was successful! The disguise was perfect, the clowns never knew what hit 'em! Once I get back to base with the bananium samples I'll be rich, I tell you! RICH!"
	},
/turf/simulated/floor/plating,
/area/ruin/unpowered)
"i" = (
/turf/simulated/shuttle/wall{
	dir = 1;
	icon_state = "swall_straight"
	},
/area/ruin/unpowered)
"k" = (
/turf/simulated/floor/shuttle/blue,
/area/ruin/unpowered)
"l" = (
/obj/structure/shuttle/engine/propulsion/burst,
/turf/simulated/shuttle/wall{
	dir = 1;
	icon_state = "swall_straight"
	},
/area/ruin/unpowered)
"m" = (
/obj/machinery/door/airlock/external{
	frequency = 1380;
	icon_state = "door_locked";
	id_tag = "escape_pod_3_hatch";
	locked = 1;
	name = "Escape Pod Hatch";
	req_access = list(13)
	},
/turf/simulated/floor/shuttle/blue,
/area/ruin/unpowered)

(1,1,1) = {"
a
a
a
a
a
a
a
a
a
a
a
a
a
a
a
a
a
a
a
a
"}
(2,1,1) = {"
a
a
a
c
c
b
b
a
a
a
a
a
a
a
a
a
b
b
a
a
"}
(3,1,1) = {"
a
a
b
c
c
b
a
a
a
a
a
a
a
a
b
b
b
b
a
a
"}
(4,1,1) = {"
a
a
b
c
c
b
a
a
a
a
a
a
b
b
b
b
b
a
a
b
"}
(5,1,1) = {"
a
a
b
b
b
b
b
a
a
a
a
a
a
a
b
b
b
a
a
a
"}
(6,1,1) = {"
a
a
a
b
b
b
b
b
a
a
a
a
a
a
a
a
a
a
b
a
"}
(7,1,1) = {"
a
a
a
b
c
b
b
b
a
a
a
a
a
a
a
a
a
a
a
a
"}
(8,1,1) = {"
a
a
a
b
b
b
b
b
a
a
a
a
a
a
a
a
a
a
a
a
"}
(9,1,1) = {"
a
a
a
a
b
b
b
b
b
b
a
a
a
a
a
a
a
a
a
a
"}
(10,1,1) = {"
a
a
a
a
b
b
b
b
a
a
a
a
a
b
b
a
a
a
a
a
"}
(11,1,1) = {"
a
a
a
a
a
b
c
c
a
a
a
a
b
b
b
b
b
b
a
a
"}
(12,1,1) = {"
a
a
a
a
a
a
a
a
a
a
a
a
b
b
b
g
i
i
l
a
"}
(13,1,1) = {"
a
a
a
a
a
a
a
a
a
a
a
c
c
b
b
f
k
k
m
a
"}
(14,1,1) = {"
a
a
a
a
a
a
a
a
a
a
a
c
c
b
f
f
i
i
l
a
"}
(15,1,1) = {"
a
a
a
a
a
a
a
a
b
b
b
b
b
b
b
b
b
b
a
a
"}
(16,1,1) = {"
a
a
a
a
a
b
b
b
b
b
b
b
a
a
c
c
b
a
a
a
"}
(17,1,1) = {"
a
a
a
a
b
b
b
b
b
a
a
a
a
a
a
a
a
a
a
a
"}
(18,1,1) = {"
a
a
a
a
a
a
b
a
a
a
a
a
a
a
a
a
a
a
a
a
"}
(19,1,1) = {"
a
a
a
a
a
a
a
a
a
a
a
a
a
a
a
a
a
a
a
a
"}
(20,1,1) = {"
a
a
a
a
a
a
a
a
a
a
a
a
a
a
a
a
a
a
a
a
"}
