//MAP CONVERTED BY dmm2tgm.py THIS HEADER COMMENT PREVENTS RECONVERSION, DO NOT REMOVE
"a" = (
/turf/template_noop,
/area/template_noop)
"c" = (
/turf/simulated/mineral/random/high_chance,
/area/ruin/unpowered)

(1,1,1) = {"
a
a
a
a
a
a
a
a
a
a
a
a
a
a
a
a
a
a
a
a
"}
(2,1,1) = {"
a
a
a
a
a
a
a
a
a
a
a
a
a
a
a
a
a
a
a
a
"}
(3,1,1) = {"
a
a
a
a
a
a
a
a
a
a
a
a
a
a
a
a
a
a
a
a
"}
(4,1,1) = {"
a
a
a
a
a
a
a
a
a
a
a
a
c
c
c
a
a
a
a
a
"}
(5,1,1) = {"
a
a
a
c
c
a
a
a
a
a
a
c
c
c
c
a
a
a
c
a
"}
(6,1,1) = {"
a
a
a
c
c
a
a
a
a
c
c
c
c
c
c
a
a
a
a
a
"}
(7,1,1) = {"
a
a
a
a
c
a
a
a
a
c
c
c
c
a
a
a
a
a
a
a
"}
(8,1,1) = {"
a
a
a
a
a
a
a
a
c
c
c
c
c
a
a
a
a
a
a
a
"}
(9,1,1) = {"
a
a
a
a
a
a
a
a
a
c
c
a
a
a
a
a
a
a
a
a
"}
(10,1,1) = {"
a
a
a
a
a
c
a
a
a
a
a
a
a
a
a
a
a
a
a
a
"}
(11,1,1) = {"
a
a
a
a
a
c
c
c
a
a
a
a
a
a
a
a
a
a
a
a
"}
(12,1,1) = {"
a
a
a
a
a
c
c
a
a
a
a
c
c
a
a
a
a
c
c
a
"}
(13,1,1) = {"
a
a
a
a
a
c
a
a
a
a
a
c
c
c
a
a
a
c
c
a
"}
(14,1,1) = {"
a
a
a
a
a
a
a
a
a
a
a
c
c
c
a
a
a
a
a
a
"}
(15,1,1) = {"
a
a
a
a
a
a
a
a
a
c
c
c
c
a
a
a
a
a
a
a
"}
(16,1,1) = {"
a
a
a
a
a
a
a
a
a
c
c
c
a
a
a
a
a
a
a
a
"}
(17,1,1) = {"
a
a
a
a
a
a
a
a
a
c
c
c
a
a
a
a
a
a
a
a
"}
(18,1,1) = {"
a
a
c
a
a
a
a
a
a
a
a
a
a
a
a
a
a
a
a
a
"}
(19,1,1) = {"
a
a
a
a
a
a
a
a
a
a
a
a
a
a
a
a
a
a
a
a
"}
(20,1,1) = {"
a
a
a
a
a
a
a
a
a
a
a
a
a
a
a
a
a
a
a
a
"}
