//MAP CONVERTED BY dmm2tgm.py THIS HEADER COMMENT PREVENTS RECONVERSION, DO NOT REMOVE
"a" = (
/turf/template_noop,
/area/template_noop)
"b" = (
/turf/simulated/mineral,
/area/ruin/unpowered)
"c" = (
/turf/simulated/mineral/random/high_chance,
/area/ruin/unpowered)
"d" = (
/turf/template_noop,
/area/ruin/unpowered)

(1,1,1) = {"
a
a
a
a
a
a
a
a
a
a
a
a
a
a
a
a
a
a
a
a
a
a
a
a
a
a
a
a
a
a
a
a
a
a
a
a
a
a
a
a
"}
(2,1,1) = {"
a
a
a
a
a
a
a
a
a
a
a
a
a
a
a
a
a
a
a
a
a
a
a
a
a
a
a
a
a
a
a
b
c
c
c
a
a
a
a
a
"}
(3,1,1) = {"
a
a
a
a
a
a
a
a
a
a
a
a
a
a
a
a
a
a
a
a
a
a
a
a
a
a
a
a
a
a
a
b
c
c
c
c
b
a
a
a
"}
(4,1,1) = {"
a
a
a
a
a
a
b
b
c
c
a
a
a
a
a
a
a
a
a
a
a
a
a
a
a
a
a
a
a
a
a
a
b
c
c
c
b
b
b
a
"}
(5,1,1) = {"
a
a
a
a
a
a
b
b
b
b
b
a
a
a
a
a
a
a
a
a
a
a
a
a
a
a
a
a
a
a
a
a
b
b
b
b
b
b
b
a
"}
(6,1,1) = {"
a
a
a
a
c
c
c
b
b
b
b
b
b
b
a
a
a
a
a
a
a
a
a
a
a
a
a
a
a
a
a
a
b
b
b
b
b
b
b
a
"}
(7,1,1) = {"
a
a
a
a
c
c
c
c
b
b
b
b
b
b
c
c
c
a
a
a
a
a
a
a
a
b
b
a
a
a
a
b
b
b
b
b
b
b
b
a
"}
(8,1,1) = {"
a
a
a
a
c
c
c
c
b
b
b
b
b
b
c
c
c
a
a
a
a
a
a
a
b
a
a
a
a
b
c
c
c
c
b
b
b
b
b
a
"}
(9,1,1) = {"
a
a
a
b
c
c
c
b
b
b
a
a
a
a
b
b
b
a
a
a
a
a
a
a
a
a
a
b
b
b
c
c
c
c
b
b
c
c
a
a
"}
(10,1,1) = {"
a
a
a
b
b
b
b
b
a
a
a
a
a
a
a
a
b
a
a
a
a
a
a
b
a
a
b
b
b
b
c
c
c
c
b
b
c
c
a
a
"}
(11,1,1) = {"
a
a
b
b
b
b
b
c
a
a
a
a
a
a
a
a
c
a
a
a
a
a
a
a
a
a
b
c
c
c
c
c
c
c
b
b
b
b
a
a
"}
(12,1,1) = {"
a
a
b
b
b
b
b
a
a
a
a
a
a
a
a
a
b
a
a
a
a
a
a
a
a
b
b
c
c
a
c
a
a
a
b
b
b
a
a
a
"}
(13,1,1) = {"
a
a
b
b
b
b
a
a
a
a
a
a
a
a
a
a
a
a
a
a
a
a
a
a
a
c
c
c
a
a
a
a
a
a
b
b
b
b
a
a
"}
(14,1,1) = {"
a
a
b
b
b
c
a
a
a
a
a
a
a
a
a
a
a
a
a
a
a
a
b
a
a
c
c
b
a
d
c
a
a
a
b
b
b
b
a
a
"}
(15,1,1) = {"
a
a
b
b
b
c
a
a
a
a
a
a
a
a
a
a
a
a
a
a
a
a
a
a
b
c
c
b
a
a
b
a
a
a
b
b
b
b
a
a
"}
(16,1,1) = {"
a
b
b
b
a
a
a
a
a
a
a
a
b
a
a
a
a
a
a
a
a
a
a
a
b
c
c
b
b
b
b
a
a
a
b
b
b
b
a
a
"}
(17,1,1) = {"
a
b
b
b
a
a
a
a
a
a
a
a
a
a
a
a
a
a
a
a
a
a
a
a
b
c
c
b
b
a
a
a
a
a
b
b
b
b
b
a
"}
(18,1,1) = {"
a
b
b
b
a
a
a
a
a
a
a
a
a
a
a
a
b
b
b
a
a
a
a
a
b
b
b
b
b
a
a
a
a
b
b
b
b
c
c
a
"}
(19,1,1) = {"
a
c
c
a
a
a
a
a
b
b
a
a
a
a
a
a
b
b
b
b
a
a
a
a
b
b
b
b
a
a
a
c
b
b
c
c
b
c
c
a
"}
(20,1,1) = {"
a
c
c
a
a
a
a
a
b
b
b
a
a
a
a
b
b
c
c
b
a
a
b
a
b
b
b
b
a
a
a
b
b
b
c
c
b
c
c
a
"}
(21,1,1) = {"
a
c
c
a
a
a
a
a
b
b
b
a
a
a
a
b
b
b
a
a
a
a
b
a
a
a
b
b
a
a
a
a
b
b
b
b
b
c
c
a
"}
(22,1,1) = {"
a
c
c
b
a
a
a
a
a
a
a
a
a
a
a
a
a
a
a
a
a
a
b
a
a
a
c
c
c
b
a
a
b
b
b
b
b
b
b
a
"}
(23,1,1) = {"
a
b
b
b
a
a
a
a
a
a
a
a
a
a
a
a
a
a
a
a
a
a
a
a
a
a
a
c
c
b
a
a
b
b
b
b
b
b
b
a
"}
(24,1,1) = {"
a
a
b
b
a
a
a
a
a
a
a
a
a
a
a
b
a
a
a
a
a
a
a
a
a
a
a
a
a
a
a
a
b
b
b
b
b
b
a
a
"}
(25,1,1) = {"
a
a
b
b
c
a
a
a
a
a
a
a
a
a
a
a
a
a
a
a
a
a
a
a
a
b
c
a
a
a
a
a
b
b
b
b
b
b
a
a
"}
(26,1,1) = {"
a
a
b
b
b
b
a
a
a
a
a
a
a
a
a
a
a
a
a
a
a
a
a
a
a
a
a
a
a
a
a
a
c
c
b
a
a
a
a
a
"}
(27,1,1) = {"
a
a
b
b
b
b
a
a
a
a
a
a
a
a
a
a
a
a
a
a
a
a
a
a
a
a
a
a
a
a
a
a
a
a
a
a
a
a
a
a
"}
(28,1,1) = {"
a
a
b
b
c
c
b
b
b
a
a
a
b
b
a
a
a
a
a
a
a
a
b
a
a
a
a
a
a
a
a
a
a
a
a
a
a
a
a
a
"}
(29,1,1) = {"
a
a
a
b
c
c
b
b
b
b
b
b
b
b
a
a
a
a
a
a
a
b
b
b
a
a
a
a
a
a
a
a
a
a
a
a
a
a
a
a
"}
(30,1,1) = {"
a
a
a
a
a
a
a
b
b
b
b
b
a
a
a
a
a
a
a
a
a
c
b
b
a
a
a
a
a
a
a
a
a
a
a
a
a
a
a
a
"}
(31,1,1) = {"
a
a
a
a
a
a
a
a
a
a
a
a
a
a
a
a
a
a
a
a
a
b
b
b
b
b
b
a
a
a
a
a
a
a
a
a
a
a
a
a
"}
(32,1,1) = {"
a
a
a
a
a
a
a
a
a
a
a
a
a
a
a
a
a
a
a
a
a
b
b
b
b
b
b
b
a
a
a
a
a
a
a
a
a
a
a
a
"}
(33,1,1) = {"
a
a
a
a
a
a
a
a
a
a
a
a
a
a
a
a
a
a
a
b
b
b
b
b
b
b
b
c
a
a
a
a
a
a
a
a
a
a
a
a
"}
(34,1,1) = {"
a
a
a
a
a
a
a
a
a
a
a
a
a
a
a
a
a
a
a
a
a
a
c
c
c
b
b
c
b
a
a
a
a
a
a
a
b
b
a
a
"}
(35,1,1) = {"
a
a
a
a
a
a
a
a
a
a
a
a
a
a
a
a
a
a
a
a
a
a
a
a
a
b
b
b
b
a
a
a
a
a
a
b
b
b
a
a
"}
(36,1,1) = {"
a
a
a
a
a
a
a
a
a
a
a
a
b
b
b
a
a
a
b
b
b
a
a
a
a
b
b
b
c
a
a
a
a
a
b
b
b
b
a
a
"}
(37,1,1) = {"
a
a
a
a
a
a
a
a
a
a
a
b
c
c
c
b
b
b
b
b
b
b
a
a
b
b
b
a
a
a
a
a
a
a
b
b
b
a
a
a
"}
(38,1,1) = {"
a
a
a
a
a
a
a
a
a
a
b
c
c
c
c
b
b
b
b
b
b
c
c
b
b
b
b
a
a
a
a
a
a
a
a
a
a
a
a
a
"}
(39,1,1) = {"
a
a
a
a
a
a
a
a
a
a
a
a
c
c
c
b
a
a
a
b
b
b
b
b
a
a
a
a
a
a
a
a
a
a
a
a
a
a
a
a
"}
(40,1,1) = {"
a
a
a
a
a
a
a
a
a
a
a
a
a
a
a
a
a
a
a
a
a
a
a
a
a
a
a
a
a
a
a
a
a
a
a
a
a
a
a
a
"}
