//MAP CONVERTED BY dmm2tgm.py THIS HEADER COMMENT PREVENTS RECONVERSION, DO NOT REMOVE
"a" = (
/turf/template_noop,
/area/template_noop)
"c" = (
/obj/item/trash/popcorn,
/turf/space,
/area/template_noop)
"i" = (
/obj/item/stack/rods,
/turf/template_noop,
/area/template_noop)
"l" = (
/obj/item/stack/cable_coil{
	amount = 10
	},
/turf/space,
/area/template_noop)
"m" = (
/turf/simulated/wall,
/area/template_noop)
"p" = (
/obj/random/plushie,
/turf/space,
/area/template_noop)
"t" = (
/obj/machinery/computer/arcade/battle,
/turf/simulated/floor,
/area/template_noop)
"u" = (
/obj/random/tool,
/turf/space,
/area/template_noop)
"v" = (
/obj/item/trash/syndi_cakes,
/turf/space,
/area/template_noop)
"A" = (
/turf/space,
/area/template_noop)
"B" = (
/obj/item/stack/rods,
/turf/space,
/area/template_noop)
"D" = (
/obj/item/paper,
/obj/item/paper,
/turf/space,
/area/template_noop)
"I" = (
/obj/item/stack/rods,
/obj/item/stack/rods,
/turf/space,
/area/template_noop)
"J" = (
/obj/item/trash/pistachios,
/turf/space,
/area/template_noop)
"K" = (
/obj/structure/lattice,
/obj/structure/girder,
/turf/space,
/area/template_noop)
"L" = (
/obj/structure/girder,
/turf/space,
/area/template_noop)
"O" = (
/obj/structure/girder/displaced,
/turf/space,
/area/template_noop)
"S" = (
/obj/structure/lattice,
/turf/space,
/area/template_noop)
"V" = (
/obj/item/circuitboard/arcade,
/turf/space,
/area/template_noop)
"Z" = (
/obj/item/paper,
/turf/space,
/area/template_noop)

(1,1,1) = {"
a
a
a
i
a
a
a
a
a
a
a
a
a
a
a
a
a
a
a
a
"}
(2,1,1) = {"
a
a
a
a
a
a
a
a
a
a
i
a
a
a
a
a
i
a
a
a
"}
(3,1,1) = {"
a
a
A
A
A
A
A
A
A
A
A
A
A
A
A
A
A
A
a
a
"}
(4,1,1) = {"
a
a
A
B
A
B
A
A
A
A
A
A
A
A
B
B
A
A
a
a
"}
(5,1,1) = {"
i
a
A
A
A
A
A
A
A
A
A
A
A
A
A
A
A
A
a
i
"}
(6,1,1) = {"
a
a
A
A
I
A
B
A
A
B
B
A
A
A
A
A
A
A
a
a
"}
(7,1,1) = {"
a
a
A
A
A
A
A
O
A
A
A
A
m
A
A
A
A
A
a
a
"}
(8,1,1) = {"
a
a
A
B
A
A
A
A
A
A
A
A
m
A
A
B
A
A
a
a
"}
(9,1,1) = {"
a
a
A
A
m
A
A
A
A
S
A
A
A
B
A
A
O
A
a
a
"}
(10,1,1) = {"
a
a
A
A
A
A
Z
A
A
B
S
A
A
L
A
c
A
A
a
a
"}
(11,1,1) = {"
a
i
B
A
A
S
A
u
A
A
S
A
Z
A
A
A
A
A
a
a
"}
(12,1,1) = {"
a
a
A
A
A
A
A
L
S
m
m
B
A
A
Z
A
B
A
i
a
"}
(13,1,1) = {"
a
a
A
A
B
O
A
B
A
A
A
D
K
A
S
A
B
A
a
a
"}
(14,1,1) = {"
a
a
A
A
A
A
S
B
A
A
B
A
m
t
A
A
A
A
a
a
"}
(15,1,1) = {"
a
a
A
A
A
A
A
A
A
S
A
B
A
A
A
A
O
A
a
a
"}
(16,1,1) = {"
a
a
A
A
S
A
S
A
B
B
A
A
S
A
A
B
u
A
a
i
"}
(17,1,1) = {"
a
a
A
A
A
A
Z
B
A
S
B
S
A
A
J
A
A
A
a
a
"}
(18,1,1) = {"
a
a
B
A
A
A
A
A
A
A
B
A
A
O
A
A
A
A
a
a
"}
(19,1,1) = {"
i
a
A
A
A
A
S
A
S
A
A
m
p
A
A
B
A
A
a
a
"}
(20,1,1) = {"
a
a
A
B
A
O
A
v
A
V
A
A
B
L
A
A
A
A
a
a
"}
(21,1,1) = {"
a
a
A
A
A
A
A
A
A
A
Z
A
B
A
A
A
A
A
a
a
"}
(22,1,1) = {"
a
a
A
A
A
O
m
m
L
A
B
A
A
B
A
A
A
A
a
a
"}
(23,1,1) = {"
a
a
A
B
A
A
B
A
B
A
A
A
O
A
A
B
B
A
a
a
"}
(24,1,1) = {"
a
a
A
A
A
A
A
A
A
A
l
A
A
A
A
A
A
A
a
a
"}
(25,1,1) = {"
a
a
A
A
B
A
A
A
A
A
A
B
A
A
A
A
A
A
a
a
"}
(26,1,1) = {"
a
a
A
A
A
A
A
A
B
A
B
A
A
B
A
B
A
A
a
a
"}
(27,1,1) = {"
a
a
B
A
A
A
B
A
A
A
B
A
A
A
A
A
A
A
a
a
"}
(28,1,1) = {"
a
a
A
A
A
A
A
A
A
A
A
A
A
A
A
A
A
A
a
i
"}
(29,1,1) = {"
i
a
a
a
a
a
a
i
a
a
a
a
a
a
a
a
a
a
a
a
"}
(30,1,1) = {"
a
a
a
a
a
a
a
a
a
a
a
a
a
a
a
a
a
i
a
a
"}
