"a" = (/turf/simulated/floor/plating,/area/template_noop)
"k" = (/obj/effect/decal/cleanable/vomit,/turf/simulated/floor/plating,/area/template_noop)
"o" = (/obj/effect/decal/cleanable/greenglow,/obj/item/reagent_containers/chem_disp_cartridge/radium,/turf/simulated/floor/plating,/area/template_noop)
"A" = (/obj/effect/decal/cleanable/blood,/turf/simulated/floor/plating,/area/template_noop)
"E" = (/obj/effect/decal/cleanable/cobweb,/turf/simulated/floor/plating,/area/template_noop)
"H" = (/obj/item/clothing/suit/radiation,/obj/item/clothing/head/radiation,/obj/item/clothing/mask/gas/clear,/turf/simulated/floor/plating,/area/template_noop)

(1,1,1) = {"
EHk
aok
kAa
"}
