"a" = (/obj/effect/decal/cleanable/blood/oil,/obj/effect/floor_decal/rust,/obj/item/organ/internal/eyes,/turf/simulated/floor/tiled,/area/template_noop)
"c" = (/obj/effect/floor_decal/rust,/obj/structure/table/standard,/obj/item/retractor,/obj/item/hemostat,/obj/item/clothing/glasses/eyepatch,/obj/item/reagent_containers/vessel/bottle/vodka/fivelakes,/obj/effect/decal/cleanable/cobweb2,/turf/simulated/floor/plating,/area/template_noop)
"f" = (/obj/effect/floor_decal/rust,/turf/simulated/floor/tiled,/area/template_noop)
"h" = (/obj/structure/table/rack,/obj/item/clothing/suit/storage/toggle/labcoat,/obj/item/clothing/suit/surgicalapron,/turf/simulated/floor/plating,/area/template_noop)
"o" = (/obj/effect/floor_decal/rust,/obj/structure/table/standard,/obj/item/reagent_containers/vessel/beaker,/obj/item/storage/box/bloodpacks,/obj/item/reagent_containers/syringe/inaprovaline,/obj/item/reagent_containers/ivbag/blood/AMinus,/obj/item/reagent_containers/ivbag/blood/APlus,/obj/item/reagent_containers/dropper,/turf/simulated/floor/plating,/area/template_noop)
"A" = (/turf/simulated/floor/plating,/area/template_noop)
"C" = (/obj/effect/floor_decal/rust,/obj/effect/decal/cleanable/blood/gibs/limb,/turf/simulated/floor/tiled,/area/template_noop)
"R" = (/obj/effect/floor_decal/rust,/obj/structure/sink{dir = 8; pixel_x = -12; pixel_y = 2},/turf/simulated/floor/tiled,/area/template_noop)

(1,1,1) = {"
Rfc
CaA
oAh
"}
