"a" = (/obj/structure/table/woodentable,/obj/item/clothing/glasses/eyepatch,/obj/item/clothing/shoes/cheapboots,/turf/simulated/floor/trim/wood,/area/template_noop)
"f" = (/obj/machinery/vending/fashionvend,/obj/effect/floor_decal/corner/grey{dir = 6},/obj/structure/noticeboard{pixel_x = -32},/turf/simulated/floor/tiled/dark/rough,/area/template_noop)
"m" = (/obj/effect/floor_decal/corner/grey{dir = 10},/turf/simulated/floor/tiled/dark/rough,/area/template_noop)
"n" = (/obj/item/stool/bar_new/padded,/turf/simulated/floor/trim/wood/broken2,/area/template_noop)
"u" = (/obj/effect/decal/cleanable/blood,/turf/simulated/floor/trim/wood,/area/template_noop)
"F" = (/obj/structure/undies_wardrobe,/obj/effect/floor_decal/corner/grey{dir = 10},/obj/effect/decal/cleanable/cobweb2,/turf/simulated/floor/tiled/dark/rough,/area/template_noop)
"O" = (/obj/effect/floor_decal/corner/grey{dir = 6},/turf/simulated/floor/tiled/dark/rough,/area/template_noop)
"R" = (/obj/effect/decal/cleanable/blood,/obj/effect/decal/cleanable/blood/gibs/limb,/turf/simulated/floor/trim/wood/broken5,/area/template_noop)
"S" = (/obj/structure/table/woodentable,/obj/effect/floor_decal/corner/grey,/obj/item/clothing/shoes/sandal,/obj/item/toy/katana,/obj/effect/decal/cleanable/cobweb,/obj/structure/mirror{pixel_y = 32},/turf/simulated/floor/tiled/dark/rough,/area/template_noop)

(1,1,1) = {"
SmF
OnR
fua
"}
