"a" = (/obj/effect/floor_decal/industrial/box/yellow,/obj/structure/closet/crate,/obj/random/maintenance,/turf/simulated/floor/plating,/area/template_noop)
"b" = (/obj/effect/floor_decal/industrial/box/yellow,/obj/structure/closet/crate,/obj/machinery/light/small{dir = 1; icon_state = "bulb"},/obj/random/maintenance,/turf/simulated/floor/plating,/area/template_noop)

(1,1,1) = {"
aab
aaa
aaa
"}
