"a" = (/obj/effect/floor_decal/industrial/warning/corner,/obj/structure/table/standard,/obj/item/stack/cable_coil/random,/turf/simulated/floor/plating,/area/template_noop)
"b" = (/obj/structure/table/standard,/obj/machinery/recharger,/obj/effect/floor_decal/industrial/warning{dir = 1},/turf/simulated/floor/plating,/area/template_noop)
"n" = (/obj/effect/floor_decal/industrial/warning/corner{dir = 1},/obj/effect/floor_decal/industrial/warning/corner{dir = 8},/turf/simulated/floor/plating,/area/template_noop)
"o" = (/obj/effect/floor_decal/industrial/warning{dir = 4},/turf/simulated/floor/plating,/area/template_noop)
"p" = (/obj/machinery/recharge_station,/obj/effect/floor_decal/industrial/warning/corner{dir = 4},/turf/simulated/floor/plating,/area/template_noop)
"z" = (/obj/structure/bed/chair/office/dark{dir = 8},/obj/effect/floor_decal/industrial/warning/corner{dir = 1},/turf/simulated/floor/plating,/area/template_noop)
"I" = (/obj/effect/floor_decal/industrial/warning,/obj/structure/table/standard,/obj/item/cell/high,/turf/simulated/floor/plating,/area/template_noop)
"J" = (/obj/effect/floor_decal/industrial/warning/corner{dir = 8},/obj/structure/table/standard,/obj/item/cell/potato,/turf/simulated/floor/plating,/area/template_noop)
"U" = (/obj/machinery/mech_recharger,/turf/simulated/floor/plating,/area/template_noop)

(1,1,1) = {"
IJa
Uno
bzp
"}
