"a" = (/obj/structure/table/standard,/obj/effect/decal/cleanable/dirt,/obj/effect/floor_decal/rust,/obj/item/storage/box/lights/tubes,/obj/item/storage/belt/janitor,/obj/item/storage/bag/trash,/obj/effect/decal/cleanable/cobweb,/turf/simulated/floor/plating,/area/template_noop)
"b" = (/obj/effect/floor_decal/industrial/hatch/yellow,/obj/structure/reagent_dispensers/watertank,/obj/structure/mirror{pixel_y = 28},/obj/effect/decal/cleanable/cobweb2,/turf/simulated/floor/plating,/area/template_noop)
"c" = (/obj/effect/floor_decal/industrial/outline/yellow,/obj/effect/decal/cleanable/dirt,/obj/effect/floor_decal/rust,/obj/item/mop,/obj/item/reagent_containers/vessel/bucket,/obj/structure/sink{dir = 8; pixel_x = -12; pixel_y = 2},/turf/simulated/floor/plating,/area/template_noop)
"x" = (/obj/effect/decal/cleanable/dirt,/obj/effect/floor_decal/rust,/turf/simulated/floor/plating,/area/template_noop)
"A" = (/obj/effect/decal/cleanable/pie_smudge,/obj/effect/decal/cleanable/dirt,/obj/effect/floor_decal/rust,/turf/simulated/floor/plating,/area/template_noop)
"H" = (/obj/effect/floor_decal/industrial/outline/yellow,/obj/structure/closet,/obj/effect/decal/cleanable/dirt,/obj/item/clothing/under/dress/maid,/obj/item/clothing/gloves/color/long_evening_gloves,/obj/item/clothing/shoes/laceup,/turf/simulated/floor/plating,/area/template_noop)
"O" = (/obj/effect/decal/cleanable/dirt,/turf/simulated/floor/plating,/area/template_noop)
"S" = (/obj/effect/floor_decal/industrial/hatch/yellow,/obj/effect/decal/cleanable/dirt,/obj/structure/mopbucket,/obj/machinery/light/small/hl{dir = 4},/turf/simulated/floor/plating,/area/template_noop)

(1,1,1) = {"
aHb
OAx
cOS
"}
