"a" = (/obj/structure/undies_wardrobe,/turf/simulated/floor/trim/carpet/purple,/area/template_noop)
"g" = (/obj/item/bedsheet,/obj/structure/bed,/mob/living/simple_animal/hostile/russian,/turf/simulated/floor/trim/carpet/purple,/area/template_noop)
"i" = (/obj/structure/table/woodentable,/obj/item/clothing/head/kitty,/obj/item/clothing/under/schoolgirl,/turf/simulated/floor/trim/carpet/purple,/area/template_noop)
"x" = (/turf/simulated/floor/trim/carpet/purple,/area/template_noop)
"H" = (/obj/structure/table/woodentable,/obj/item/handcuffs,/obj/item/clothing/glasses/sunglasses/blindfold,/obj/item/clothing/mask/muzzle/ballgag,/turf/simulated/floor/trim/carpet/purple,/area/template_noop)

(1,1,1) = {"
axH
xgx
xxi
"}
