"a" = (/obj/effect/floor_decal/jungledirt/grass,/turf/simulated/floor/natural/grass,/area/template_noop)
"o" = (/obj/effect/floor_decal/jungledirt/grass,/obj/structure/flora/ausbushes/sparsegrass,/turf/simulated/floor/natural/grass,/area/template_noop)
"w" = (/obj/effect/floor_decal/jungledirt/grass,/obj/structure/flora/tree/green/small/tree4,/turf/simulated/floor/natural/grass,/area/template_noop)
"x" = (/obj/effect/floor_decal/jungledirt/grass,/obj/structure/flora/jungleplants/junglebushlarge/bush4,/turf/simulated/floor/natural/grass,/area/template_noop)
"D" = (/obj/effect/floor_decal/jungledirt/grass,/mob/living/simple_animal/corgi/Lisa,/turf/simulated/floor/natural/grass,/area/template_noop)

(1,1,1) = {"
waa
aoo
aDx
"}
