"a" = (/turf/simulated/floor/plating,/area/template_noop)
"f" = (/obj/structure/window/reinforced,/obj/machinery/door/window/northright{dir = 4},/mob/living/simple_animal/corgi,/obj/structure/dogbed,/obj/effect/floor_decal/industrial/box/orange,/turf/simulated/floor/plating,/area/template_noop)
"k" = (/obj/structure/table/standard,/obj/machinery/microwave,/obj/item/reagent_containers/food/cheeseburger,/obj/machinery/light/small/red{dir = 4},/turf/simulated/floor/plating,/area/template_noop)
"t" = (/obj/structure/window/reinforced{dir = 1},/obj/machinery/door/window/southleft{dir = 4},/mob/living/simple_animal/corgi,/obj/structure/dogbed,/obj/effect/floor_decal/industrial/box/orange,/turf/simulated/floor/plating,/area/template_noop)
"E" = (/obj/structure/window/reinforced{dir = 1},/obj/machinery/door/window/southright{dir = 8},/obj/item/reagent_containers/food/meat/corgi,/obj/item/material/knife/butch/kitchen,/obj/effect/decal/cleanable/blood,/obj/structure/dogbed,/obj/effect/floor_decal/industrial/box/orange,/turf/simulated/floor/plating,/area/template_noop)
"N" = (/obj/effect/gibspawner/generic,/turf/simulated/floor/plating,/area/template_noop)
"U" = (/obj/effect/decal/cleanable/blood,/turf/simulated/floor/plating,/area/template_noop)

(1,1,1) = {"
fak
UNa
taE
"}
