"a" = (/obj/effect/floor_decal/rust,/obj/structure/table/rack,/obj/item/ammo_magazine/caps,/obj/item/ammo_magazine/caps,/obj/item/ammo_magazine/caps,/obj/item/ammo_magazine/caps,/turf/simulated/floor/tiled/rough,/area/template_noop)
"k" = (/obj/effect/floor_decal/rust,/obj/effect/decal/cleanable/blood,/obj/machinery/light/small{dir = 8},/turf/simulated/floor/tiled/rough,/area/template_noop)
"H" = (/obj/effect/floor_decal/rust,/turf/simulated/floor/tiled/rough,/area/template_noop)
"N" = (/obj/effect/floor_decal/rust,/obj/structure/table/rack,/obj/item/gun/projectile/revolver/capgun,/obj/item/gun/projectile/revolver/capgun,/turf/simulated/floor/tiled/rough,/area/template_noop)
"R" = (/obj/effect/floor_decal/rust,/obj/item/caution/cone,/turf/simulated/floor/tiled/rough,/area/template_noop)

(1,1,1) = {"
kHR
RNH
aHa
"}
