"a" = (/obj/effect/decal/cleanable/blood/gibs/xeno/limb,/turf/simulated/floor/plating,/area/template_noop)
"b" = (/obj/structure/bed,/obj/effect/decal/cleanable/vomit,/turf/simulated/floor/plating,/area/template_noop)
"c" = (/obj/effect/decal/cleanable/ash,/turf/simulated/floor/plating,/area/template_noop)
"f" = (/obj/effect/decal/cleanable/blood/gibs/down,/turf/simulated/floor/plating,/area/template_noop)
"k" = (/obj/effect/decal/cleanable/blood/gibs/core,/turf/simulated/floor/plating,/area/template_noop)
"n" = (/turf/simulated/floor/plating,/area/template_noop)
"A" = (/obj/effect/gibspawner/human,/obj/effect/decal/cleanable/vomit,/turf/simulated/floor/plating,/area/template_noop)
"J" = (/obj/effect/decal/cleanable/blood/gibs/body,/turf/simulated/floor/plating,/area/template_noop)
"K" = (/obj/effect/decal/cleanable/blood/gibs/limb,/turf/simulated/floor/plating,/area/template_noop)

(1,1,1) = {"
kbn
cAK
faJ
"}
