"a" = (/obj/effect/floor_decal/rust,/obj/structure/closet,/obj/item/stack/material/wood/ten,/obj/random/maintenance,/turf/simulated/floor/tiled/rough,/area/template_noop)
"i" = (/obj/effect/floor_decal/rust,/turf/simulated/floor/tiled/rough,/area/template_noop)
"p" = (/obj/effect/floor_decal/plaque,/turf/simulated/floor/tiled/rough,/area/template_noop)
"q" = (/obj/effect/floor_decal/rust,/obj/structure/closet,/obj/item/material/knife/kitchen,/obj/random/maintenance,/turf/simulated/floor/tiled/rough,/area/template_noop)
"z" = (/obj/effect/floor_decal/rust,/obj/structure/closet,/obj/random/maintenance,/obj/machinery/light/small{dir = 1},/turf/simulated/floor/tiled/rough,/area/template_noop)

(1,1,1) = {"
zii
ipi
aiq
"}
