"a" = (/obj/effect/floor_decal/jungledirt/grass,/obj/structure/flora/jungleplants/junglebushlarge/bush4,/turf/space,/area/template_noop)
"f" = (/obj/effect/floor_decal/jungledirt/grass,/obj/item/reagent_containers/food/grown/orange,/turf/space,/area/template_noop)
"o" = (/obj/effect/floor_decal/jungledirt/grass,/obj/item/reagent_containers/food/grown/grapes,/turf/space,/area/template_noop)
"r" = (/obj/effect/floor_decal/jungledirt/grass,/turf/space,/area/template_noop)
"z" = (/obj/effect/floor_decal/jungledirt/grass,/obj/item/reagent_containers/food/grown/apple,/turf/space,/area/template_noop)
"E" = (/obj/effect/floor_decal/jungledirt/grass,/obj/item/reagent_containers/food/grown/lemon,/turf/space,/area/template_noop)
"G" = (/obj/effect/floor_decal/jungledirt/grass,/obj/item/reagent_containers/food/grown/carrot,/turf/space,/area/template_noop)
"I" = (/obj/effect/floor_decal/jungledirt/grass,/obj/structure/table/woodentable,/obj/item/trash/dish/bowl,/turf/space,/area/template_noop)
"X" = (/obj/effect/floor_decal/jungledirt/grass,/obj/item/reagent_containers/food/grown/banana,/turf/space,/area/template_noop)

(1,1,1) = {"
rzX
oIE
aGf
"}
