"a" = (/obj/structure/table/woodentable,/obj/effect/decal/cleanable/dirt,/obj/item/material/twohanded/baseballbat,/obj/item/device/taperecorder/empty,/turf/simulated/floor/trim/wood/broken4,/area/template_noop)
"r" = (/obj/effect/decal/cleanable/dirt,/obj/effect/decal/cleanable/dirt,/turf/simulated/floor/trim/wood,/area/template_noop)
"z" = (/obj/structure/closet/cabinet,/obj/effect/decal/cleanable/dirt,/obj/item/clothing/suit/storage/toggle/varsity/brown,/obj/item/clothing/shoes/laceup,/obj/item/clothing/under/casual_pants/classicjeans,/turf/simulated/floor/trim/wood,/area/template_noop)
"B" = (/obj/structure/table/woodentable,/obj/effect/decal/cleanable/dirt,/obj/item/device/tape/random,/obj/item/material/brass_knuckle{name = "knuckles"},/obj/item/material/brass_knuckle{name = "knuckles"},/obj/item/clothing/mask/animal_mask/jackal,/obj/item/clothing/suit/storage/toggle/punk_jacket_AC,/obj/item/clothing/under/casual_pants/blackjeans,/obj/item/clothing/shoes/cheapboots,/turf/simulated/floor/trim/wood,/area/template_noop)
"E" = (/obj/structure/table/woodentable,/obj/effect/decal/cleanable/dirt,/obj/item/handcuffs,/obj/item/modular_computer/tablet/preset/custom_loadout/cheap,/turf/simulated/floor/trim/wood,/area/template_noop)
"F" = (/obj/effect/decal/cleanable/dirt,/turf/simulated/floor/trim/wood/broken6,/area/template_noop)
"J" = (/obj/effect/decal/cleanable/dirt,/turf/simulated/floor/trim/wood/broken3,/area/template_noop)
"L" = (/obj/structure/table/woodentable,/obj/effect/decal/cleanable/dirt,/obj/item/clothing/head/richard,/turf/simulated/floor/trim/wood,/area/template_noop)
"N" = (/obj/effect/decal/cleanable/dirt,/obj/structure/bed/chair/wood{dir = 4},/turf/simulated/floor/trim/wood,/area/template_noop)

(1,1,1) = {"
zLE
FNa
rJB
"}
