"a" = (/turf/simulated/floor/plating,/area/template_noop)
"z" = (/mob/living/simple_animal/hostile/mimic/sleeping,/turf/simulated/floor/plating,/area/template_noop)

(1,1,1) = {"
aaa
aza
aaa
"}
