"a" = (/turf/simulated/floor/trim/lino,/area/template_noop)
"H" = (/obj/machinery/light/small/quartz,/obj/random/toy,/turf/simulated/floor/trim/lino,/area/template_noop)
"O" = (/obj/random/snack,/turf/simulated/floor/trim/lino,/area/template_noop)
"V" = (/obj/machinery/light/small/quartz{dir = 1},/obj/random/toy,/turf/simulated/floor/trim/lino,/area/template_noop)

(1,1,1) = {"
VaV
aOa
HaH
"}
