"a" = (/turf/simulated/floor/plating,/area/template_noop)
"l" = (/obj/effect/gibspawner/human,/turf/simulated/floor/plating,/area/template_noop)
"q" = (/mob/living/simple_animal/hostile/maneater,/turf/simulated/floor/plating,/area/template_noop)
"F" = (/obj/effect/decal/cleanable/blood,/turf/simulated/floor/plating,/area/template_noop)

(1,1,1) = {"
FFl
aFa
aaa
Fla
qFa
"}
