"a" = (/obj/structure/closet/emcloset/legacy,/obj/effect/floor_decal/rust,/turf/simulated/floor/tiled/dirty,/area/template_noop)
"d" = (/obj/effect/floor_decal/rust,/obj/effect/floor_decal/industrial/warning/corner{dir = 8},/obj/effect/floor_decal/industrial/warning{dir = 8},/turf/simulated/floor/plating,/area/template_noop)
"i" = (/obj/effect/floor_decal/rust,/obj/effect/floor_decal/industrial/warning{dir = 8},/turf/simulated/floor/plating,/area/template_noop)
"m" = (/obj/structure/closet/emcloset,/turf/simulated/floor/tiled/dirty,/area/template_noop)
"o" = (/obj/structure/closet/emcloset/legacy,/turf/simulated/floor/tiled/dirty,/area/template_noop)
"p" = (/obj/effect/floor_decal/rust,/obj/effect/floor_decal/industrial/warning/corner{dir = 8},/obj/effect/floor_decal/industrial/warning/corner{dir = 1},/turf/simulated/floor/plating,/area/template_noop)
"v" = (/obj/structure/closet/l3closet,/turf/simulated/floor/plating,/area/template_noop)
"I" = (/obj/structure/closet/firecloset/full,/obj/effect/floor_decal/rust,/turf/simulated/floor/plating,/area/template_noop)
"J" = (/turf/simulated/floor/plating,/area/template_noop)
"O" = (/obj/machinery/portable_atmospherics/canister/air,/obj/effect/decal/warning_stripes,/turf/simulated/floor/plating,/area/template_noop)
"S" = (/obj/structure/closet/emcloset,/obj/machinery/light/small/emergency{dir = 8},/turf/simulated/floor/tiled/dirty,/area/template_noop)
"T" = (/obj/effect/floor_decal/rust,/obj/effect/floor_decal/industrial/warning{dir = 1},/obj/effect/floor_decal/industrial/warning,/turf/simulated/floor/plating,/area/template_noop)
"X" = (/obj/machinery/portable_atmospherics/canister/oxygen,/obj/effect/decal/warning_stripes,/turf/simulated/floor/plating,/area/template_noop)
"Z" = (/obj/effect/floor_decal/rust,/obj/effect/floor_decal/rust,/obj/effect/floor_decal/industrial/warning{dir = 8},/turf/simulated/floor/plating,/area/template_noop)

(1,1,1) = {"
miv
SdI
TpJ
aZX
oiO
"}
