"a" = (/turf/simulated/wall,/area/template_noop)
"c" = (/obj/structure/bed/chair/brown{dir = 8},/turf/simulated/floor/tiled/white,/area/template_noop)
"e" = (/obj/structure/reagent_dispensers/water_cooler,/turf/simulated/floor/trim/carpet/blue,/area/template_noop)
"y" = (/obj/structure/closet,/obj/item/storage/pill_bottle/paroxetine,/obj/item/storage/pill_bottle/methylphenidate,/obj/item/storage/pill_bottle/happy,/obj/item/storage/pill_bottle/citalopram,/obj/item/storage/pill_bottle/zoom,/obj/item/gun/launcher/syringe,/obj/item/storage/box/syringes,/obj/item/storage/box/syringegun,/obj/item/handcuffs,/obj/item/clothing/suit/straight_jacket,/obj/item/clothing/mask/muzzle,/obj/item/clothing/glasses/sunglasses/blindfold,/obj/item/device/tape/random,/obj/item/device/tape/random,/obj/item/device/tape/random,/obj/item/device/camera,/obj/item/device/camera_film,/obj/item/device/camera_film,/obj/item/clothing/glasses/hud/health,/turf/simulated/floor/trim/carpet/blue,/area/template_noop)
"B" = (/obj/machinery/door/airlock/glass_medical,/turf/simulated/floor/tiled/white,/area/template_noop)
"G" = (/obj/structure/bed/couch/left/brown{dir = 4},/turf/simulated/floor/trim/carpet/blue,/area/template_noop)
"K" = (/obj/structure/bed/couch/right/brown{dir = 4},/turf/simulated/floor/trim/carpet/blue,/area/template_noop)
"R" = (/turf/simulated/floor/trim/carpet/blue,/area/template_noop)
"S" = (/obj/structure/table/woodentable,/obj/item/pen,/obj/item/paper_bin,/obj/item/storage/pill_bottle/happy,/turf/simulated/floor/tiled/white,/area/template_noop)
"U" = (/obj/structure/bed/chair/office/light{dir = 8},/turf/simulated/floor/trim/carpet/blue,/area/template_noop)
"Y" = (/obj/structure/bed/couch/middle/brown{dir = 4},/turf/simulated/floor/trim/carpet/blue,/area/template_noop)
"Z" = (/turf/simulated/floor/tiled/white,/area/template_noop)

(1,1,1) = {"
KRy
YUe
GRR
aaB
ScZ
"}
