"a" = (/obj/effect/floor_decal/stairs,/obj/machinery/door/airlock/sandstone,/obj/item/bananapeel,/turf/simulated/floor/tiled/rough,/area/template_noop)
"d" = (/obj/item/bananapeel,/turf/simulated/floor/trim/carpet/orange,/area/template_noop)
"z" = (/obj/structure/sign/warning,/turf/simulated/wall/sandstone,/area/template_noop)
"D" = (/obj/item/bananapeel,/turf/simulated/floor/tiled/rough,/area/template_noop)
"M" = (/mob/living/simple_animal/hostile/retaliate/clown{name = "Sanya"},/obj/item/bananapeel,/turf/simulated/floor/trim/carpet/orange,/area/template_noop)
"N" = (/obj/item/bedsheet/clown,/obj/structure/bed,/obj/item/bananapeel,/turf/simulated/floor/trim/carpet/orange,/area/template_noop)
"U" = (/obj/structure/sign/xenobio_1,/turf/simulated/wall/sandstone,/area/template_noop)

(1,1,1) = {"
DDD
DDD
DDD
azU
dMN
"}
