"a" = (/obj/effect/decal/cleanable/dirt,/turf/simulated/floor/tiled/white/rough,/area/template_noop)
"f" = (/obj/structure/table/standard,/obj/item/clothing/mask/gas/clear,/turf/simulated/floor/tiled/white/rough,/area/template_noop)
"i" = (/turf/simulated/floor/tiled/white/rough,/area/template_noop)
"n" = (/obj/machinery/portable_atmospherics/canister/oxygen,/turf/simulated/floor/tiled/white/rough,/area/template_noop)
"o" = (/obj/machinery/portable_atmospherics/canister/nitrogen,/obj/structure/window/reinforced,/turf/simulated/floor/tiled/white/rough,/area/template_noop)
"H" = (/obj/machinery/portable_atmospherics/canister/air,/turf/simulated/floor/tiled/white/rough,/area/template_noop)
"J" = (/obj/machinery/portable_atmospherics/canister/hydrogen,/obj/structure/window/reinforced,/turf/simulated/floor/tiled/white/rough,/area/template_noop)
"M" = (/obj/effect/decal/cleanable/blood,/obj/effect/floor_decal/industrial/caution/red,/obj/effect/decal/cleanable/dirt,/turf/simulated/floor/tiled/white/rough,/area/template_noop)
"X" = (/obj/structure/reagent_dispensers/fueltank,/obj/effect/decal/cleanable/dirt,/turf/simulated/floor/tiled/white/rough,/area/template_noop)
"Y" = (/obj/structure/table/standard,/obj/item/storage/toolbox/mechanical,/turf/simulated/floor/tiled/white/rough,/area/template_noop)
"Z" = (/obj/structure/closet/emcloset,/obj/effect/decal/cleanable/dirt,/turf/simulated/floor/tiled/white/rough,/area/template_noop)

(1,1,1) = {"
Hin
Jio
iMi
Zaf
XaY
"}
