"a" = (/obj/structure/disposalpipe/segment{icon_state = "pipe-c"; dir = 4},/turf/simulated/floor/trim/lino,/area/template_noop)
"b" = (/obj/structure/disposalpipe/segment{icon_state = "pipe-c"; dir = 8},/turf/simulated/floor/trim/lino,/area/template_noop)
"h" = (/obj/machinery/disposal/deliveryChute,/obj/structure/disposalpipe/trunk{dir = 1},/turf/simulated/floor/trim/lino,/area/template_noop)
"i" = (/obj/structure/disposalpipe/segment{dir = 8},/obj/structure/disposalpipe/segment,/obj/structure/shuttle/window,/turf/simulated/floor/trim/lino,/area/template_noop)
"k" = (/obj/machinery/disposal/deliveryChute{dir = 1},/obj/structure/disposalpipe/trunk{dir = 1},/turf/simulated/floor/trim/lino,/area/template_noop)
"q" = (/obj/machinery/disposal/deliveryChute{dir = 8},/obj/structure/disposalpipe/trunk{dir = 8},/turf/simulated/floor/trim/lino,/area/template_noop)
"r" = (/obj/machinery/disposal/deliveryChute{dir = 4},/obj/structure/disposalpipe/trunk,/turf/simulated/floor/trim/lino,/area/template_noop)
"s" = (/obj/machinery/disposal/deliveryChute,/obj/structure/disposalpipe/trunk,/turf/simulated/floor/trim/lino,/area/template_noop)
"z" = (/obj/machinery/disposal/deliveryChute{dir = 4},/obj/structure/disposalpipe/trunk{dir = 4},/turf/simulated/floor/trim/lino,/area/template_noop)
"I" = (/obj/structure/disposalpipe/trunk{dir = 4},/turf/simulated/floor/trim/lino,/area/template_noop)
"O" = (/obj/machinery/disposal/deliveryChute{dir = 1},/obj/structure/disposalpipe/trunk,/turf/simulated/floor/trim/lino,/area/template_noop)
"V" = (/obj/structure/disposalpipe/trunk{dir = 8},/turf/simulated/floor/trim/lino,/area/template_noop)
"W" = (/obj/machinery/disposal/deliveryChute{dir = 8},/obj/structure/disposalpipe/trunk{dir = 1},/turf/simulated/floor/trim/lino,/area/template_noop)

(1,1,1) = {"
rIq
hOs
aib
khO
zVW
"}
