"a" = (/obj/effect/floor_decal/industrial/warning,/obj/effect/decal/cleanable/blood,/turf/simulated/floor/trim/wood/broken6,/area/template_noop)
"b" = (/obj/effect/floor_decal/industrial/warning/corner{dir = 4},/obj/structure/casino/oh_bandit,/turf/simulated/floor/trim/wood,/area/template_noop)
"e" = (/obj/effect/floor_decal/industrial/warning/corner{dir = 1},/obj/structure/table/standard,/obj/item/device/radio/intercept,/turf/simulated/floor/trim/wood,/area/template_noop)
"f" = (/obj/item/stool/bar/padded,/turf/simulated/floor/trim/carpet/green,/area/template_noop)
"h" = (/obj/item/stool/bar/padded,/turf/simulated/floor/trim/wood,/area/template_noop)
"i" = (/obj/effect/floor_decal/industrial/warning{dir = 4},/obj/effect/decal/cleanable/blood,/turf/simulated/floor/trim/wood/broken5,/area/template_noop)
"l" = (/obj/effect/floor_decal/industrial/warning/corner{dir = 1},/obj/structure/table/woodentable,/obj/item/reagent_containers/vessel/bottle/premiumvodka,/obj/item/reagent_containers/vessel/glass/shot{pixel_x = 5; pixel_y = 2},/obj/item/reagent_containers/vessel/glass/shot{pixel_x = -5; pixel_y = 2},/obj/effect/decal/cleanable/cobweb2,/turf/simulated/floor/tiled/dark,/area/template_noop)
"w" = (/turf/simulated/floor/trim/wood,/area/template_noop)
"E" = (/obj/effect/floor_decal/industrial/warning{dir = 1},/obj/effect/decal/cleanable/blood,/turf/simulated/floor/trim/carpet/green,/area/template_noop)
"G" = (/obj/effect/floor_decal/industrial/warning/corner,/obj/structure/casino/oh_bandit,/turf/simulated/floor/tiled/dark,/area/template_noop)
"K" = (/obj/effect/floor_decal/industrial/warning/corner{dir = 4},/obj/structure/flora/pottedplant/crystal,/obj/effect/decal/cleanable/cobweb,/turf/simulated/floor/trim/carpet/green,/area/template_noop)
"P" = (/obj/effect/floor_decal/industrial/warning/corner{dir = 8},/obj/structure/table/woodentable,/obj/item/flame/lighter/zippo,/obj/item/flame/lighter/zippo,/turf/simulated/floor/trim/carpet/green,/area/template_noop)
"R" = (/obj/effect/floor_decal/industrial/warning/corner,/obj/machinery/vending/cigarette,/turf/simulated/floor/trim/wood,/area/template_noop)
"Y" = (/obj/effect/floor_decal/industrial/warning{dir = 8},/turf/simulated/floor/trim/wood/broken3,/area/template_noop)
"Z" = (/obj/effect/floor_decal/industrial/warning/corner{dir = 8},/obj/structure/table/woodentable,/obj/item/device/taperecorder,/obj/item/storage/briefcase,/turf/simulated/floor/trim/wood,/area/template_noop)

(1,1,1) = {"
KEl
PfG
Ywi
ehb
RaZ
"}
