"a" = (/obj/structure/closet/crate/freezer,/obj/item/organ/internal/eyes,/obj/item/organ/internal/eyes/optics,/obj/item/organ/internal/eyes/robot,/turf/simulated/floor/tiled/white,/area/template_noop)
"c" = (/obj/effect/floor_decal/industrial/warning{dir = 1},/turf/simulated/floor/tiled/white,/area/template_noop)
"d" = (/obj/effect/floor_decal/rust,/obj/machinery/optable,/obj/effect/mob_spawn/corpse/human/damaged,/obj/machinery/light/small/quartz{dir = 8},/turf/simulated/floor/tiled/white,/area/template_noop)
"n" = (/obj/effect/floor_decal/rust,/mob/living/simple_animal/hostile/retaliate/jelly,/turf/simulated/floor/tiled/white,/area/template_noop)
"p" = (/obj/effect/floor_decal/industrial/warning{dir = 9},/turf/simulated/floor/tiled/white,/area/template_noop)
"t" = (/obj/effect/floor_decal/industrial/warning{dir = 5},/obj/effect/floor_decal/rust,/turf/simulated/floor/tiled/white,/area/template_noop)
"w" = (/obj/effect/floor_decal/industrial/hatch/orange,/obj/structure/closet/l3closet,/turf/simulated/floor/tiled/dirty,/area/template_noop)
"F" = (/obj/structure/iv_drip,/turf/simulated/floor/tiled/dirty,/area/template_noop)
"K" = (/turf/simulated/floor/tiled/white,/area/template_noop)
"L" = (/obj/effect/floor_decal/rust,/obj/structure/computerframe,/turf/simulated/floor/tiled/white,/area/template_noop)
"Q" = (/turf/simulated/floor/tiled/dirty,/area/template_noop)
"R" = (/obj/machinery/shower{dir = 8},/obj/effect/floor_decal/corner/grey/full,/turf/simulated/floor/tiled/techfloor/ridge,/area/template_noop)
"S" = (/obj/structure/sink{dir = 4; pixel_x = 11},/turf/simulated/floor/tiled/dirty,/area/template_noop)
"X" = (/obj/effect/floor_decal/rust,/obj/effect/floor_decal/rust,/obj/structure/table/glass,/obj/item/scalpel,/obj/item/hemostat,/turf/simulated/floor/tiled/white,/area/template_noop)

(1,1,1) = {"
wQR
FQS
pct
dnX
LKa
"}
