"a" = (/obj/item/cigbutt,/obj/effect/floor_decal/corner/grey/full,/turf/simulated/floor/plating,/area/template_noop)
"b" = (/obj/structure/closet/emcloset/legacy,/obj/effect/floor_decal/corner/grey/full,/turf/simulated/floor/plating,/area/template_noop)
"d" = (/obj/structure/bed/chair,/obj/effect/floor_decal/corner/orange/full,/turf/simulated/floor/plating,/area/template_noop)
"h" = (/obj/structure/table/standard,/obj/item/stack/material/plastic/ten,/obj/effect/floor_decal/corner/orange/full,/turf/simulated/floor/plating,/area/template_noop)
"t" = (/obj/effect/floor_decal/corner/grey/full,/turf/simulated/floor/plating,/area/template_noop)
"u" = (/obj/effect/floor_decal/corner/old/yellow/full,/turf/simulated/floor/plating,/area/template_noop)
"x" = (/obj/structure/table/standard,/obj/effect/floor_decal/corner/old/yellow/full,/obj/item/stamp/denied,/turf/simulated/floor/plating,/area/template_noop)
"A" = (/obj/structure/bed/chair,/obj/effect/floor_decal/corner/old/yellow/full,/turf/simulated/floor/plating,/area/template_noop)
"G" = (/obj/structure/table/rack,/obj/item/circuitboard/autolathe,/obj/effect/floor_decal/corner/grey/full,/turf/simulated/floor/plating,/area/template_noop)
"J" = (/obj/structure/bed/chair,/obj/effect/floor_decal/corner/grey/full,/turf/simulated/floor/plating,/area/template_noop)
"U" = (/obj/effect/floor_decal/corner/orange/full,/turf/simulated/floor/plating,/area/template_noop)

(1,1,1) = {"
dUJ
hUt
tat
AuG
xub
"}
