"a" = (/obj/effect/floor_decal/jungledirt/grass,/obj/structure/sink/puddle{layer = 2},/obj/effect/decal/cleanable/dirt,/obj/structure/flora/ausbushes/reedbush,/turf/space,/area/template_noop)
"k" = (/obj/effect/floor_decal/jungledirt/grass,/obj/structure/flora/jungleplants/junglebushlarge,/obj/effect/decal/cleanable/dirt,/turf/space,/area/template_noop)
"n" = (/obj/effect/floor_decal/jungledirt/grass,/obj/structure/sink/puddle{layer = 2},/obj/structure/flora/ausbushes/reedbush,/obj/effect/decal/cleanable/dirt,/turf/space,/area/template_noop)
"p" = (/obj/effect/floor_decal/jungledirt/grass,/obj/structure/flora/ausbushes/ywflowers,/obj/effect/decal/cleanable/dirt,/turf/space,/area/template_noop)
"r" = (/obj/effect/floor_decal/jungledirt/grass,/obj/item/reagent_containers/food/grown/banana,/obj/structure/flora/ausbushes/ywflowers,/obj/effect/decal/cleanable/dirt,/turf/space,/area/template_noop)
"z" = (/obj/effect/floor_decal/jungledirt/grass,/mob/living/carbon/human/monkey,/obj/effect/decal/cleanable/dirt,/turf/space,/area/template_noop)
"D" = (/obj/effect/floor_decal/jungledirt/grass,/obj/item/beach_ball,/obj/effect/decal/cleanable/dirt,/obj/structure/flora/ausbushes/jungleflora/grassa,/turf/space,/area/template_noop)
"L" = (/obj/effect/floor_decal/jungledirt/grass,/obj/item/reagent_containers/food/grown/banana,/obj/effect/decal/cleanable/dirt,/obj/structure/flora/ausbushes/jungleflora/grassa,/turf/space,/area/template_noop)
"R" = (/obj/effect/floor_decal/jungledirt/grass,/obj/effect/decal/cleanable/dirt,/obj/structure/flora/ausbushes/brflowers,/turf/space,/area/template_noop)
"Y" = (/obj/effect/floor_decal/jungledirt/grass,/mob/living/carbon/human/monkey,/obj/machinery/light{dir = 4},/obj/effect/decal/cleanable/dirt,/turf/space,/area/template_noop)

(1,1,1) = {"
zRr
zkY
Lnz
pzD
azp
"}
