"a" = (/obj/effect/floor_decal/industrial/box/yellow,/obj/structure/closet/crate/handmade,/obj/item/ore/silver,/obj/item/ore/silver,/obj/item/ore/silver,/obj/item/ore/silver,/obj/item/ore/silver,/turf/simulated/floor/plating,/area/template_noop)
"c" = (/obj/effect/floor_decal/industrial/box/yellow,/obj/structure/ore_box,/turf/simulated/floor/plating,/area/template_noop)
"f" = (/obj/effect/floor_decal/industrial/box/yellow,/obj/structure/closet/crate/handmade,/obj/item/ore/hydrogen,/obj/item/ore/hydrogen,/obj/item/ore/hydrogen,/obj/item/ore/hydrogen,/obj/item/ore/hydrogen,/turf/simulated/floor/plating,/area/template_noop)
"t" = (/obj/effect/floor_decal/industrial/box/yellow,/obj/structure/closet/crate/handmade,/obj/item/ore/plasma,/obj/item/ore/plasma,/obj/item/ore/plasma,/obj/item/ore/plasma,/obj/item/ore/plasma,/turf/simulated/floor/plating,/area/template_noop)
"u" = (/obj/effect/floor_decal/industrial/box/yellow,/obj/structure/closet/crate/handmade,/obj/item/ore/uranium,/obj/item/ore/uranium,/obj/item/ore/uranium,/obj/item/ore/uranium,/obj/item/ore/uranium,/turf/simulated/floor/plating,/area/template_noop)
"y" = (/obj/structure/skele_stand,/turf/simulated/floor/plating,/area/template_noop)
"F" = (/obj/effect/floor_decal/industrial/box/yellow,/obj/structure/closet/crate/handmade,/obj/item/ore/iron,/obj/item/ore/iron,/obj/item/ore/iron,/obj/item/ore/iron,/obj/item/ore/iron,/turf/simulated/floor/plating,/area/template_noop)
"S" = (/obj/effect/floor_decal/industrial/box/yellow,/obj/structure/closet/crate/handmade,/obj/item/ore/gold,/obj/item/ore/gold,/obj/item/ore/gold,/obj/item/ore/gold,/obj/item/ore/gold,/turf/simulated/floor/plating,/area/template_noop)
"T" = (/obj/effect/floor_decal/industrial/box/yellow,/obj/structure/table/rack,/obj/item/device/flashlight/lantern/active,/obj/item/pickaxe,/turf/simulated/floor/plating,/area/template_noop)
"U" = (/turf/simulated/floor/plating,/area/template_noop)

(1,1,1) = {"
SUf
FUt
UUU
ayT
uUc
"}
