"a" = (/turf/simulated/floor/grid/greengrid,/area/template_noop)
"b" = (/obj/effect/decal/cleanable/dirt,/turf/simulated/floor/grid/greengrid,/area/template_noop)
"e" = (/obj/effect/floor_decal/corner_steel_grid/full,/obj/effect/decal/cleanable/blood/oil,/obj/effect/decal/cleanable/liquid_fuel,/obj/random/maintenance,/turf/simulated/floor/plating,/area/template_noop)
"f" = (/obj/effect/floor_decal/corner_steel_grid/full,/obj/effect/decal/cleanable/liquid_fuel,/obj/structure/reagent_dispensers/fueltank,/turf/simulated/floor/plating,/area/template_noop)
"m" = (/obj/effect/floor_decal/corner_steel_grid/full,/obj/item/caution/cone,/obj/effect/decal/cleanable/dirt,/turf/simulated/floor/plating,/area/template_noop)
"B" = (/obj/effect/floor_decal/corner_steel_grid/full,/obj/item/book/wiki/robotics_cyborgs,/obj/structure/closet/wardrobe/robotics_black,/turf/simulated/floor/plating,/area/template_noop)
"D" = (/obj/machinery/mech_recharger,/mob/living/simple_animal/chicken/robot,/turf/simulated/floor/tiled/techfloor/grid,/area/template_noop)
"I" = (/obj/effect/floor_decal/corner_steel_grid/full,/obj/effect/decal/cleanable/liquid_fuel,/turf/simulated/floor/plating,/area/template_noop)
"M" = (/obj/effect/floor_decal/corner_steel_grid/full,/obj/effect/decal/cleanable/dirt,/turf/simulated/floor/plating,/area/template_noop)
"Q" = (/obj/structure/computerframe,/turf/simulated/floor/tiled/techfloor/grid,/area/template_noop)
"R" = (/obj/effect/decal/cleanable/dirt,/obj/random/technology_scanner,/turf/simulated/floor/grid/greengrid,/area/template_noop)
"W" = (/obj/machinery/recharge_station,/turf/simulated/floor/tiled/techfloor/grid,/area/template_noop)
"X" = (/obj/effect/floor_decal/corner_steel_grid/full,/obj/item/gun/projectile/revolver/capgun,/obj/effect/decal/cleanable/blood/oil,/turf/simulated/floor/plating,/area/template_noop)
"Y" = (/obj/effect/floor_decal/corner_steel_grid/full,/turf/simulated/floor/plating,/area/template_noop)

(1,1,1) = {"
fYB
eXm
IMM
aRb
WDQ
"}
