"a" = (/obj/effect/floor_decal/rust,/obj/structure/table/standard,/obj/item/clothing/glasses/welding,/obj/item/crowbar,/turf/simulated/floor/tiled/white,/area/template_noop)
"b" = (/obj/effect/decal/cleanable/blood/oil,/turf/simulated/floor/tiled/dirty,/area/template_noop)
"d" = (/obj/effect/floor_decal/industrial/warning,/obj/effect/decal/cleanable/blood/oil,/turf/simulated/floor/tiled/dirty,/area/template_noop)
"p" = (/obj/effect/floor_decal/rust,/obj/structure/closet,/obj/random/maintenance,/obj/random/maintenance,/turf/simulated/floor/tiled/white,/area/template_noop)
"r" = (/obj/item/clothing/glasses/welding,/turf/simulated/floor/tiled/dirty,/area/template_noop)
"t" = (/obj/effect/floor_decal/rust,/obj/structure/table/standard,/obj/item/stock_parts/capacitor,/obj/item/stock_parts/scanning_module,/turf/simulated/floor/tiled/white,/area/template_noop)
"w" = (/obj/effect/decal/cleanable/blood,/turf/simulated/floor/tiled/dirty,/area/template_noop)
"F" = (/obj/effect/floor_decal/rust,/turf/simulated/floor/tiled/white,/area/template_noop)
"H" = (/obj/item/stack/cable_coil/random,/turf/simulated/floor/tiled/dirty,/area/template_noop)
"L" = (/obj/effect/decal/mecha_wreckage/durand,/obj/effect/decal/warning_stripes,/turf/simulated/floor/tiled/dirty,/area/template_noop)
"S" = (/obj/effect/floor_decal/rust,/obj/structure/reagent_dispensers/fueltank,/turf/simulated/floor/tiled/white,/area/template_noop)
"T" = (/obj/effect/floor_decal/industrial/warning,/turf/simulated/floor/tiled/dirty,/area/template_noop)
"V" = (/obj/machinery/light/small/hl{dir = 8},/obj/effect/decal/cleanable/blood,/turf/simulated/floor/tiled/dirty,/area/template_noop)

(1,1,1) = {"
Hwr
VLb
dTT
tFS
aFp
"}
