"an" = (/obj/structure/window/shuttle{icon_state = "window4"},/obj/structure/grille,/turf/simulated/floor/plating,/area/space)
"aQ" = (/obj/item/archaeological_find/remains,/turf/simulated/floor/plating,/area/space)
"bs" = (/obj/effect/floor_decal/rust,/obj/effect/floor_decal/rust,/turf/simulated/floor/tiled/techfloor,/area/space)
"bZ" = (/obj/structure/computerframe,/turf/simulated/floor/shuttle/darkred,/area/space)
"cg" = (/obj/item/archaeological_find/container,/obj/machinery/atmospherics/pipe/simple/heat_exchanging,/obj/effect/decal/cleanable/cobweb2{dir = 4; icon_state = "cobweb1"},/obj/effect/decal/cleanable/blood/xeno,/obj/effect/floor_decal/trimline/purple,/turf/simulated/floor/misc/abductor,/area/space)
"cl" = (/obj/structure/closet/crate,/obj/item/archaeological_find/crystal,/obj/item/archaeological_find/crystal,/turf/simulated/floor/shuttle/pod,/area/space)
"cs" = (/obj/effect/decal/cleanable/ash,/turf/simulated/floor/plating{icon_state = "dmg1"},/area/space)
"cv" = (/obj/effect/floor_decal/rust,/obj/item/device/flashlight/flare{on = 1},/turf/simulated/floor/plating,/area/space)
"cM" = (/obj/effect/floor_decal/rust,/obj/machinery/conveyor{id = "mining_shuttle_internal"},/turf/simulated/floor/tiled/techfloor,/area/space)
"cZ" = (/obj/effect/floor_decal/rust,/obj/item/ammo_casing/a50/used,/obj/effect/floor_decal/trimline/yellow/filled/warning{dir = 4},/turf/simulated/floor/tiled/techfloor,/area/space)
"dt" = (/obj/item/frame/light{dir = 4; pixel_x = 14},/turf/simulated/floor/shuttle/pod,/area/space)
"dY" = (/obj/structure/table/steel_reinforced,/obj/item/reagent_containers/vessel/plastic/waterbottle/fi4i{pixel_y = 8},/turf/simulated/floor/asteroid,/area/space)
"ec" = (/obj/structure/computerframe,/turf/simulated/floor/shuttle/pod,/area/space)
"eg" = (/obj/effect/floor_decal/rust,/obj/effect/floor_decal/rust,/turf/simulated/floor/plating{icon_state = "dmg1"},/area/space)
"ej" = (/turf/simulated/floor/plating{icon_state = "dmg3"},/area/space)
"ex" = (/obj/effect/floor_decal/rust,/obj/structure/table/glass/plass,/turf/simulated/floor/tiled/techfloor,/area/space)
"ez" = (/obj/item/ammo_casing/a50/used,/turf/simulated/floor/plating,/area/space)
"eL" = (/obj/machinery/atmospherics/pipe/simple/heat_exchanging,/turf/simulated/floor/misc/abductor,/area/space)
"fr" = (/obj/machinery/constructable_frame,/turf/simulated/floor/plating,/area/space)
"ga" = (/obj/item/clothing/suit/space/void/exploration/prepared,/turf/simulated/floor/asteroid,/area/space)
"gg" = (/obj/effect/floor_decal/trimline/yellow/filled/warning{dir = 6},/turf/simulated/floor/plating,/area/space)
"gy" = (/turf/simulated/open,/area/space)
"gD" = (/obj/effect/decal/cleanable/dirt,/turf/simulated/floor/shuttle/pod,/area/space)
"hg" = (/obj/structure/lattice,/obj/structure/lattice,/obj/structure/lattice,/turf/simulated/open,/area/space)
"hm" = (/turf/simulated/wall/iron,/area/space)
"hv" = (/turf/simulated/floor/tiled/techfloor,/area/space)
"hw" = (/obj/machinery/access_button{command = "cycle_exterior"; dir = 8; frequency = 1379; master_tag = "ancient_airlock"; name = "exterior access button"; pixel_x = 10; req_access = list(13)},/turf/simulated/shuttle/wall{dir = 1; icon_state = "swall"},/area/space)
"hF" = (/obj/machinery/conveyor{dir = 8; id = "HydroDelivery"},/turf/simulated/floor/plating,/area/space)
"hT" = (/obj/item/remains/human,/obj/effect/decal/cleanable/blood,/turf/simulated/floor/plating,/area/space)
"ic" = (/obj/effect/floor_decal/rust,/turf/simulated/floor/tiled/techfloor,/area/space)
"ij" = (/obj/effect/floor_decal/rust,/turf/simulated/wall/iron,/area/space)
"is" = (/obj/item/remains/human,/obj/effect/decal/cleanable/blood/writing,/obj/effect/decal/cleanable/blood/oil,/obj/item/clothing/mask/balaclava/tactical{pixel_x = 9; pixel_y = 6; randpixel = 0},/turf/simulated/floor/plating,/area/space)
"iy" = (/obj/effect/floor_decal/rust,/obj/item/ammo_casing/a50/used,/obj/effect/floor_decal/trimline/yellow/filled/warning{dir = 4},/turf/simulated/floor/plating,/area/space)
"iP" = (/obj/effect/floor_decal/rust,/obj/item/tank/oxygen,/turf/simulated/floor/plating,/area/space)
"jf" = (/obj/structure/window_frame/reinforced/thermal,/obj/machinery/access_button{command = "cycle_interior"; dir = 4; frequency = 1379; master_tag = "ancient_airlock"; pixel_x = -8; pixel_y = -7},/turf/simulated/floor/plating,/area/space)
"jl" = (/obj/machinery/atmospherics/pipe/simple/visible/blue,/obj/effect/decal/cleanable/blood/drip,/turf/simulated/floor/plating,/area/space)
"jr" = (/obj/item/remains/human,/obj/effect/decal/cleanable/blood,/obj/effect/floor_decal/trimline/yellow/filled/warning{dir = 4},/turf/simulated/floor/plating,/area/space)
"kb" = (/obj/structure/door_assembly,/turf/simulated/floor/plating,/area/space)
"ko" = (/turf/simulated/floor/plating{icon_state = "dmg1"},/area/space)
"kt" = (/obj/machinery/atmospherics/pipe/simple/visible/blue,/obj/effect/decal/cleanable/dirt,/obj/effect/decal/cleanable/spiderling_remains,/obj/machinery/light/small/he{dir = 4},/turf/simulated/floor/shuttle/purple,/area/space)
"kY" = (/turf/simulated/floor/asteroid,/area/space)
"lb" = (/obj/effect/floor_decal/rust,/obj/machinery/door/airlock/vault,/turf/simulated/floor/plating,/area/space)
"lc" = (/obj/structure/table/glass/plass,/obj/item/clothing/head/helmet/space/void/exploration,/obj/item/frame/light{dir = 1; pixel_y = 15},/turf/simulated/floor/tiled/techfloor,/area/space)
"lf" = (/obj/effect/decal/cleanable/spiderling_remains,/turf/simulated/floor/shuttle/purple,/area/space)
"lg" = (/obj/item/asteroid/anomalous_core,/turf/simulated/floor/asteroid,/area/space)
"lr" = (/obj/machinery/atmospherics/pipe/simple/visible/blue,/obj/effect/decal/cleanable/dirt,/turf/simulated/floor/shuttle/purple,/area/space)
"lz" = (/obj/item/material/shard/plasma,/obj/effect/decal/cleanable/dirt,/obj/effect/decal/cleanable/generic,/turf/simulated/floor/shuttle/purple,/area/space)
"lG" = (/turf/simulated/floor/shuttle/darkred,/area/space)
"mo" = (/obj/effect/floor_decal/rust,/obj/item/ammo_casing/a50/used,/turf/simulated/floor/plating{icon_state = "dmg1"},/area/space)
"mG" = (/obj/effect/floor_decal/rust,/obj/machinery/sleeper,/turf/simulated/floor/tiled/techfloor,/area/space)
"mJ" = (/obj/item/frame/light{dir = 1; pixel_y = 15},/obj/item/frame/air_alarm{pixel_y = 31},/turf/simulated/floor/shuttle/pod,/area/space)
"mU" = (/turf/simulated/shuttle/wall/corner/smoothwhite{dir = 8},/area/space)
"na" = (/obj/effect/floor_decal/rust,/obj/item/remains/human,/turf/simulated/floor/plating{icon_state = "dmg1"},/area/space)
"nB" = (/obj/machinery/conveyor{id = "mining_shuttle_internal"},/turf/simulated/floor/tiled/techfloor,/area/space)
"ob" = (/obj/structure/table/glass/plass,/obj/item/archaeological_find/instrument,/turf/simulated/floor/plating,/area/space)
"ok" = (/obj/structure/bed/chair/shuttle/black{dir = 1},/turf/simulated/floor/shuttle/darkred,/area/space)
"oC" = (/obj/structure/barricade,/turf/simulated/floor/plating,/area/space)
"oT" = (/mob/living/simple_animal/hostile/little_changeling/arm_chan,/turf/simulated/floor/asteroid,/area/space)
"oU" = (/obj/item/ammo_casing/a50/used,/turf/simulated/floor/asteroid,/area/space)
"pm" = (/obj/structure/barricade,/turf/simulated/floor/tiled/techfloor,/area/space)
"pD" = (/obj/effect/floor_decal/rust,/obj/structure/inflatable/wall,/turf/simulated/floor/shuttle/pod,/area/space)
"pL" = (/obj/effect/decal/cleanable/ash,/turf/simulated/mineral,/area/space)
"qh" = (/turf/simulated/mineral/random,/area/space)
"qi" = (/obj/structure/shuttle/engine/heater{dir = 8},/turf/simulated/shuttle/wall{dir = 1; icon_state = "swall_t"},/area/space)
"qo" = (/obj/effect/decal/cleanable/molten_item,/turf/simulated/floor/plating{icon_state = "dmg2"},/area/space)
"qv" = (/obj/machinery/mech_recharger,/obj/item/frame/light{dir = 8; pixel_x = -15},/turf/simulated/floor/plating,/area/space)
"qG" = (/obj/effect/forcefield,/obj/machinery/atmospherics/pipe/manifold/visible/blue,/turf/simulated/floor/plating{icon_state = "dmg1"},/area/space)
"qK" = (/obj/effect/floor_decal/rust,/obj/item/storage/toolbox/mechanical,/turf/simulated/floor/plating,/area/space)
"qL" = (/obj/item/material/shard/plasma,/obj/machinery/atmospherics/pipe/simple/heat_exchanging/junction{dir = 1},/turf/simulated/floor/shuttle/purple,/area/space)
"qQ" = (/obj/item/remains/human,/turf/simulated/floor/asteroid,/area/space)
"rn" = (/turf/simulated/floor/plating,/area/space)
"rv" = (/obj/machinery/door/airlock/external{frequency = 1380; icon_state = "door_locked"; id_tag = "ancient_inner"; locked = 1; req_access = list(13)},/turf/simulated/floor/shuttle/black,/area/space)
"rw" = (/obj/effect/decal/cleanable/blood/drip,/turf/simulated/floor/shuttle/pod,/area/space)
"rI" = (/obj/structure/grille,/obj/structure/window_frame/glass{health = 6; icon_state = "winframe_damage1"},/turf/simulated/floor/plating/rough/airless,/area/space)
"rM" = (/obj/structure/shuttle/engine/heater{dir = 8},/turf/simulated/shuttle/wall{icon_state = "swall_t"},/area/space)
"rN" = (/obj/item/frame/light{dir = 8; pixel_x = -15},/turf/simulated/floor/shuttle/pod,/area/space)
"rR" = (/obj/effect/decal/cleanable/dirt,/obj/effect/decal/cleanable/spiderling_remains,/turf/simulated/floor/shuttle/purple,/area/space)
"sn" = (/obj/effect/floor_decal/rust,/turf/simulated/floor/shuttle/pod,/area/space)
"so" = (/obj/effect/forcefield,/obj/machinery/atmospherics/pipe/simple/visible/blue{dir = 9},/turf/simulated/floor/plating{icon_state = "dmg1"},/area/space)
"sQ" = (/obj/effect/decal/cleanable/dirt,/obj/effect/decal/cleanable/ash,/turf/simulated/floor/shuttle/purple,/area/space)
"td" = (/obj/effect/floor_decal/trimline/yellow/filled/warning{dir = 4},/turf/simulated/floor/plating,/area/space)
"tS" = (/obj/effect/decal/cleanable/dirt,/turf/simulated/wall/iron,/area/space)
"tV" = (/obj/machinery/portable_atmospherics/canister/oxygen/prechilled,/turf/simulated/floor/asteroid,/area/space)
"uO" = (/obj/effect/forcefield,/obj/machinery/atmospherics/pipe/simple/visible/blue{dir = 4},/obj/item/frame/light{pixel_y = -13},/turf/simulated/floor/plating{icon_state = "dmg1"},/area/space)
"vv" = (/obj/machinery/atmospherics/pipe/simple/visible/blue,/obj/item/frame/light{pixel_y = -13},/turf/simulated/floor/plating,/area/space)
"vD" = (/obj/effect/floor_decal/rust,/obj/machinery/door/airlock/vault,/turf/simulated/floor/plating{icon_state = "dmg1"},/area/space)
"vF" = (/obj/structure/table/glass/plass,/obj/item/tank/oxygen,/turf/simulated/floor/tiled/techfloor,/area/space)
"vQ" = (/obj/effect/decal/cleanable/blood/drip,/obj/structure/door_assembly,/turf/simulated/floor/shuttle/pod,/area/space)
"wn" = (/obj/item/archaeological_find/gun,/turf/simulated/floor/plating{icon_state = "dmg1"},/area/space)
"wr" = (/obj/effect/floor_decal/rust,/obj/item/device/flashlight/flare{on = 1},/turf/simulated/floor/plating{icon_state = "dmg1"},/area/space)
"wX" = (/obj/effect/floor_decal/rust,/obj/machinery/vending_frame,/turf/simulated/floor/tiled/techfloor,/area/space)
"xf" = (/obj/machinery/atmospherics/pipe/simple/heat_exchanging/junction,/obj/effect/decal/cleanable/cobweb2{icon_state = "cobweb1"},/obj/machinery/light/small/he{dir = 1},/turf/simulated/floor/shuttle/purple,/area/space)
"xk" = (/obj/effect/decal/cleanable/dirt,/obj/item/archaeological_find/plant,/turf/simulated/floor/plating{icon_state = "dmg3"},/area/space)
"xx" = (/turf/simulated/mineral/random/high_chance,/area/space)
"xC" = (/obj/effect/decal/cleanable/dirt,/turf/simulated/floor/plating,/area/space)
"xI" = (/obj/effect/decal/cleanable/blood/gibs/xeno/core,/turf/simulated/floor/plating{icon_state = "dmg1"},/area/space)
"xK" = (/obj/structure/shuttle/engine/propulsion{dir = 8},/turf/space,/area/space)
"yc" = (/obj/machinery/conveyor{dir = 8; id = "HydroDelivery"},/obj/item/frame/light{pixel_y = -13},/turf/simulated/floor/plating,/area/space)
"yn" = (/obj/item/material/shard,/turf/simulated/floor/plating{icon_state = "dmg2"},/area/space)
"yJ" = (/obj/machinery/atmospherics/pipe/simple/visible/blue,/obj/machinery/light/small/he{dir = 4},/turf/simulated/floor/shuttle/purple,/area/space)
"zj" = (/turf/simulated/mineral,/area/space)
"zq" = (/obj/structure/lattice,/turf/simulated/open,/area/space)
"zx" = (/obj/effect/decal/cleanable/ash,/turf/simulated/floor/plating,/area/space)
"zZ" = (/obj/structure/girder,/turf/simulated/floor/plating,/area/space)
"AA" = (/obj/effect/decal/cleanable/dirt,/obj/item/archaeological_find/plant,/turf/simulated/floor/plating{icon_state = "dmg1"},/area/space)
"AI" = (/obj/effect/floor_decal/rust,/obj/structure/computerframe,/turf/simulated/floor/tiled/techfloor,/area/space)
"AJ" = (/obj/machinery/mech_recharger,/turf/simulated/floor/tiled/techfloor,/area/space)
"AV" = (/obj/effect/floor_decal/rust,/turf/simulated/floor/plating{icon_state = "dmg1"},/area/space)
"Be" = (/obj/item/material/shard,/turf/simulated/floor/plating,/area/space)
"CC" = (/obj/machinery/door/airlock/plasma{name = "Strange Airlock"},/turf/simulated/floor/plating,/area/space)
"Dc" = (/obj/machinery/constructable_frame,/obj/item/frame/air_alarm{pixel_y = 31},/turf/simulated/floor/plating,/area/space)
"Dd" = (/obj/machinery/atmospherics/pipe/simple/hidden/blue,/turf/simulated/wall/iron,/area/space)
"Dk" = (/obj/machinery/atmospherics/pipe/simple/heat_exchanging/junction,/turf/simulated/floor/shuttle/purple,/area/space)
"Dz" = (/obj/structure/table/glass/plass,/turf/simulated/floor/plating,/area/space)
"DN" = (/obj/structure/inflatable/wall,/turf/simulated/floor/plating{icon_state = "dmg1"},/area/space)
"EI" = (/obj/effect/decal/cleanable/dirt,/obj/effect/decal/cleanable/ash,/obj/item/frame/light{dir = 8; pixel_x = -15},/turf/simulated/floor/plating,/area/space)
"Fb" = (/obj/structure/table/glass/plass,/turf/simulated/floor/shuttle/pod,/area/space)
"FE" = (/turf/space,/area/space)
"FG" = (/obj/item/device/flashlight/flare{on = 1},/turf/simulated/floor/plating,/area/space)
"FR" = (/turf/simulated/shuttle/wall{dir = 6; icon_state = "swall"},/area/space)
"FY" = (/turf/simulated/shuttle/wall{dir = 5; icon_state = "swall"},/area/space)
"Gl" = (/obj/effect/floor_decal/rust,/obj/structure/inflatable/door,/turf/simulated/floor/plating,/area/space)
"GI" = (/obj/structure/inflatable/door,/turf/simulated/floor/tiled/techfloor,/area/space)
"GN" = (/obj/structure/table/glass/plass,/turf/simulated/floor/tiled/techfloor,/area/space)
"Hl" = (/obj/structure/door_assembly,/turf/simulated/floor/shuttle/pod,/area/space)
"Hq" = (/obj/structure/inflatable/door,/obj/effect/decal/cleanable/blood/drip,/turf/simulated/floor/shuttle/pod,/area/space)
"Hw" = (/obj/effect/decal/cleanable/molten_item,/turf/simulated/floor/plating{icon_state = "dmg1"},/area/space)
"Hx" = (/obj/machinery/atmospherics/pipe/simple/visible/blue,/obj/effect/decal/cleanable/generic,/turf/simulated/floor/shuttle/purple,/area/space)
"Hz" = (/obj/item/clothing/head/helmet/space/void,/turf/simulated/floor/plating,/area/space)
"Iz" = (/obj/item/archaeological_find/plant,/turf/simulated/floor/plating{icon_state = "dmg1"},/area/space)
"II" = (/obj/effect/decal/cleanable/dirt,/turf/simulated/floor/shuttle/purple,/area/space)
"Jh" = (/obj/effect/floor_decal/rust,/obj/effect/decal/cleanable/blood/oil,/obj/effect/floor_decal/trimline/yellow/filled/warning,/turf/simulated/floor/plating{icon_state = "dmg1"},/area/space)
"Jt" = (/obj/structure/window/shuttle,/obj/structure/grille,/turf/simulated/floor/plating,/area/space)
"Jz" = (/obj/item/device/flashlight/flare{on = 1},/turf/simulated/floor/tiled/techfloor,/area/space)
"JD" = (/obj/item/frame/air_alarm{pixel_y = 31},/turf/simulated/floor/tiled/techfloor,/area/space)
"JH" = (/obj/effect/floor_decal/rust,/obj/machinery/vending_frame,/obj/item/frame/light{pixel_y = -13},/turf/simulated/floor/tiled/techfloor,/area/space)
"JT" = (/obj/machinery/constructable_frame,/turf/simulated/floor/shuttle/pod,/area/space)
"JV" = (/obj/machinery/door/airlock/external{frequency = 1380; icon_state = "door_locked"; id_tag = "ancient_exterior"; locked = 1; req_access = list(13)},/turf/simulated/floor/shuttle/black,/area/space)
"Ki" = (/obj/effect/floor_decal/rust,/obj/effect/decal/cleanable/blood/oil,/obj/effect/decal/mecha_wreckage/hoverpod,/turf/simulated/floor/plating,/area/space)
"Lj" = (/obj/effect/floor_decal/trimline/yellow,/turf/simulated/floor/tiled/techfloor,/area/space)
"Ll" = (/obj/machinery/atmospherics/pipe/simple/heat_exchanging/junction{dir = 1},/obj/effect/decal/cleanable/cobweb2{icon_state = "cobweb1"},/turf/simulated/floor/plating{icon_state = "dmg1"},/area/space)
"Lm" = (/obj/structure/computerframe,/turf/simulated/floor/plating,/area/space)
"LD" = (/obj/effect/floor_decal/rust,/obj/structure/door_assembly,/turf/simulated/floor/tiled/techfloor,/area/space)
"Mf" = (/obj/item/frame/light{dir = 8; pixel_x = -15},/obj/item/device/flashlight/flare{on = 1},/turf/simulated/floor/plating,/area/space)
"Mg" = (/obj/structure/grille,/obj/structure/window_frame/rglass,/turf/simulated/floor/plating/rough/airless,/area/space)
"MT" = (/turf/simulated/floor/plating{icon_state = "dmg2"},/area/space)
"MY" = (/obj/structure/grille/broken,/turf/simulated/floor/plating{icon_state = "dmg2"},/area/space)
"NE" = (/obj/structure/girder,/turf/simulated/floor/plating{icon_state = "dmg1"},/area/space)
"Of" = (/obj/item/frame/light{pixel_y = -13},/turf/simulated/floor/shuttle/pod,/area/space)
"OM" = (/obj/structure/bed/chair/shuttle/black,/turf/simulated/floor/shuttle/darkred,/area/space)
"Pf" = (/obj/effect/floor_decal/rust,/obj/item/ammo_casing/a50/used,/turf/simulated/floor/tiled/techfloor,/area/space)
"Pl" = (/obj/item/device/flashlight/flare{on = 1},/obj/effect/floor_decal/trimline/yellow/filled/warning{dir = 4},/turf/simulated/floor/tiled/techfloor,/area/space)
"Qd" = (/obj/effect/floor_decal/rust,/obj/item/ammo_casing/a50/used,/turf/simulated/floor/plating,/area/space)
"Qf" = (/turf/simulated/floor/shuttle/pod,/area/space)
"Qg" = (/obj/item/device/flashlight/flare{on = 1},/turf/simulated/floor/asteroid,/area/space)
"QO" = (/obj/item/material/shard/plasma,/obj/effect/decal/cleanable/dirt,/turf/simulated/floor/plating{icon_state = "dmg1"},/area/space)
"QR" = (/turf/simulated/shuttle/wall{dir = 8; icon_state = "swall_s"},/area/space)
"Re" = (/obj/item/material/shard/plasma,/obj/machinery/atmospherics/pipe/simple/heat_exchanging,/obj/effect/decal/cleanable/blood/xeno,/obj/effect/floor_decal/trimline/purple,/turf/simulated/floor/misc/abductor,/area/space)
"RB" = (/obj/structure/anomaly_container,/turf/simulated/floor/asteroid,/area/space)
"RU" = (/obj/machinery/atmospherics/pipe/manifold/visible/blue,/obj/effect/forcefield,/turf/simulated/floor/plating{icon_state = "dmg1"},/area/space)
"Sj" = (/obj/machinery/atmospherics/pipe/simple/visible/blue{dir = 4},/obj/effect/forcefield,/turf/simulated/floor/plating{icon_state = "dmg1"},/area/space)
"Sp" = (/obj/machinery/conveyor{dir = 5; id = "mining_shuttle_internal"},/turf/simulated/floor/tiled/techfloor,/area/space)
"Sv" = (/obj/effect/decal/cleanable/ash,/obj/effect/decal/cleanable/molten_item,/turf/simulated/floor/plating,/area/space)
"SW" = (/obj/item/frame/light{dir = 1; pixel_y = 15},/turf/simulated/floor/plating,/area/space)
"Tn" = (/obj/structure/window_frame/reinforced/thermal,/obj/machinery/embedded_controller/radio/airlock/airlock_controller{dir = 2; id_tag = "ancient_airlock"; pixel_x = 3; req_access = list(13); pixel_y = -4; tag_exterior_door = "ancient_exterior"; tag_interior_door = "ancient_inner},/turf/simulated/floor/plating,/area/space)
"Tq" = (/obj/item/material/shard/plasma,/turf/simulated/floor/shuttle/purple,/area/space)
"TT" = (/obj/structure/shuttle/engine/heater{dir = 8},/turf/simulated/shuttle/wall{dir = 4; icon_state = "swall_straight"},/area/space)
"TU" = (/obj/item/archaeological_find/container,/obj/machinery/atmospherics/pipe/simple/heat_exchanging,/obj/effect/floor_decal/trimline/purple,/turf/simulated/floor/misc/abductor,/area/space)
"Uv" = (/obj/machinery/conveyor{id = "mining_shuttle_internal"},/obj/item/frame/light{dir = 4; pixel_x = 14},/turf/simulated/floor/tiled/techfloor,/area/space)
"Ux" = (/obj/effect/decal/cleanable/blood/drip,/turf/simulated/floor/plating,/area/space)
"UV" = (/obj/structure/grille,/turf/simulated/floor/plating/rough/airless,/area/space)
"UX" = (/obj/structure/girder,/turf/simulated/floor/plating/rough/airless,/area/space)
"Vd" = (/obj/effect/floor_decal/rust,/obj/structure/computerframe,/obj/item/frame/light{dir = 1; pixel_y = 15},/turf/simulated/floor/tiled/techfloor,/area/space)
"Vx" = (/turf/simulated/shuttle/wall/corner/smoothwhite,/area/space)
"Vz" = (/obj/effect/decal/cleanable/blood/writing,/turf/simulated/floor/shuttle/pod,/area/space)
"Wg" = (/obj/item/frame/light{dir = 1; pixel_y = 15},/turf/simulated/floor/shuttle/pod,/area/space)
"Wl" = (/turf/simulated/shuttle/wall{icon_state = "swall"},/area/space)
"Ws" = (/obj/effect/floor_decal/rust,/obj/effect/decal/cleanable/blood,/turf/simulated/floor/plating,/area/space)
"WW" = (/obj/effect/decal/cleanable/ash,/turf/simulated/floor/asteroid,/area/space)
"Xw" = (/obj/item/frame/air_alarm{pixel_y = 31},/turf/simulated/floor/plating,/area/space)
"Xz" = (/obj/item/pickaxe/drill/adv,/obj/effect/floor_decal/rust,/turf/simulated/floor/tiled/techfloor,/area/space)
"XL" = (/turf/simulated/shuttle/wall{dir = 4; icon_state = "swall_straight"},/area/space)
"XU" = (/obj/effect/step_trigger/teleporter/random/admin,/turf/space,/area/space)
"XY" = (/obj/structure/table/glass/plass,/obj/item/frame/light{dir = 1; pixel_y = 15},/turf/simulated/floor/shuttle/pod,/area/space)
"Yi" = (/obj/effect/decal/cleanable/blood,/turf/simulated/floor/asteroid,/area/space)
"Yz" = (/obj/item/frame/light{dir = 4; pixel_x = 14},/turf/simulated/floor/plating,/area/space)
"YD" = (/obj/effect/floor_decal/trimline/yellow/filled/warning{dir = 4},/turf/simulated/floor/plating{icon_state = "dmg1"},/area/space)
"YJ" = (/obj/effect/floor_decal/rust,/obj/item/frame/air_alarm{dir = 8; pixel_x = 29},/turf/simulated/floor/tiled/techfloor,/area/space)
"YK" = (/obj/structure/window/shuttle{dir = 1; icon_state = "window4"},/obj/structure/grille,/turf/simulated/floor/plating,/area/space)
"YQ" = (/obj/structure/window_frame/reinforced/thermal,/turf/simulated/floor/plating,/area/space)
"YW" = (/obj/effect/decal/cleanable/dirt,/turf/simulated/mineral,/area/space)
"Zn" = (/obj/item/frame/light{dir = 4; pixel_x = 14},/turf/simulated/floor/plating{icon_state = "dmg1"},/area/space)
"Zo" = (/obj/machinery/atmospherics/pipe/simple/heat_exchanging/junction{dir = 1},/turf/simulated/floor/shuttle/purple,/area/space)
"Zu" = (/obj/item/material/shard/plasma,/obj/machinery/atmospherics/pipe/simple/heat_exchanging,/obj/effect/decal/cleanable/greenglow,/obj/effect/floor_decal/trimline/purple,/turf/simulated/floor/misc/abductor,/area/space)
"Zz" = (/obj/machinery/door/airlock/plasma{name = "Strange Airlock"},/turf/simulated/floor/shuttle/pod,/area/space)
"ZC" = (/obj/machinery/atmospherics/pipe/simple/visible/blue,/obj/effect/decal/cleanable/cobweb2,/obj/effect/decal/cleanable/dirt,/obj/machinery/light/small/he{dir = 4},/obj/machinery/power/apc/super{dir = 1; pixel_y = 32},/turf/simulated/floor/shuttle/purple,/area/space)
"ZD" = (/obj/structure/stairs/north,/turf/simulated/floor/tiled/techfloor,/area/space)
"ZE" = (/obj/effect/floor_decal/rust,/turf/simulated/floor/plating,/area/space)

(1,1,1) = {"
qhqhqhqhqhqhqhqhqhqhqhqhqhqhzjzjzjYWYWzjzjzjzjzjzjqhqhqhqhqhqhqhqhqhqhqhqhqhqhqh
qhqhqhqhqhqhqhqhqhqhqhqhqhqhzjgyhmYWYWzjzjzjzjzjMgqhqhqhqhqhqhqhqhqhqhqhqhqhqhqh
qhqhqhqhqhqhqhqhqhqhqhqhqhqhxxgyhmtSYWhmhmzjzjhmhmgyxxgygyqhqhqhqhqhqhqhqhqhqhqh
zjzjzjzjzjqhqhqhqhqhgyzjzjzjxxgyhmrNzjhmXYJTzjFbMggygygygygyhmhmhmhmhmhmhmhmhmqh
zjzjzjzjzjqhqhqhqhqhgygyzjzjzjgyhmQfQfHlQfkoQfecMggygygygyxxhmZDZDhmVdDclcvFhmqh
zjzjzjzjzjgyzjzjzjgygygygyzjgygyhmQfQfhmkornrnecMggygygyxxxxhmhvhvhmicnakoLjhmqh
zjzjzjzjzjgygygyxxgygygygygygygyhmrNrnhmhmhmhmhmhmgygygygyxxhmpmoChmZEZEiycMhmqh
zjzjzjzjzjgygygygygygygygygygygyMgQfrnSWhmQfgDWgMgMgMgMgMgMghmGIGlDNZEQdYDUvhmqh
zjzjzjzjzjzjgygygygygygygygygygyMgQfrnQfvQQfQfrwZzHqsnrnZErnZzrnAVrnezcvjrfrhmqh
zjzjzjzjzjzjgygygygygygygygygygyMgQfQfQfhmQfQfzjhmDNrnwrsnrwhmicrnUxhvQdtdnBhmqh
zjzjzjzjzjzjzjgygygygygygygygygyMgQfQfrwhmhmzjzjzjpDQfsnQfsnZzhvezWsrnHztdnBhmqh
zjzjzjhmzjzjhmhmhmhmMgMgMgMgMgMgMgQfrwQftSzjzjzjrIMgMgMgMgMghmqvbsezegZEcZfrhmqh
zjzjzjhmzjiszjzjmJhmQfQfQfQfQfYzhmrnrnrnhmzjzjzjMggygygygygyhmAJZEkoqKKiPlUvhmqh
zjzjzjhmzjVzvvjlUxCCQfUxrnUxQfrwkbrnUxzjzjzjzjzjMggygygygygyhmhvFGhTiPJhggcMhmqh
zjzjzjhmDdCCDdDdhmhmMfBeQfQfQfQfhmrnrndthmzjzjzjMggygygygygyhmwXJHezkoychFSphmqh
zjzjzjzjxflzDkZChmhmMgMYMgMgMgMghmhmHlhmhmzjzjzjMggygygygygyhmhmhmvDhmhmhmhmhmqh
zjzjzjTqRerRTUlrhmgygygygygygygyMgXwrnQfHlrnzjQfMggygygygygyhmicezrnobDzmGmGhmqh
zjzjeLsQeLIIeLyJhmgygygygygygygyMgrnrnQfhmrnrnQfMggygygygygyhmPfrnrnZEmoZEYJhmqh
zjzjZuQOcglfTUHxhmgygygygygygygyMgrnrnrnhmrnrnclMggygygygygyhmicZEhmlbijhmhmhmqh
zjzjLlkoqLIIZokthmgygygygygygygyMgkokodthmOfQfLmMggygygygygyhmicichmicicJDhvhmqh
zjzjzjuOqGSjRUsohmhmhmhmzZzqgygyMgQfcshmhmhmhmhmhmgygygygygyhmLDhmhmJzhvXzhvhmqh
zjzjzjhmNEkbNEhmzZrncsejMTzqgygyrIrnrnIzrnQfzxkohmgygygygygyhmhvGNhmzjAVzjzjqhzj
zjzjzjhmzjxIwnzjzZkoqoejzqzqgygyMYBeMThmEIAAzjZnhmgygygygygyhmAIexzjzjAVzjzjkYzj
zjzjzjhmzjHwxIzjcskozqzqgyzqzqgygyzqzqzZxCYWzjQfhmgygygygygyhmhmhmqhqhkohmhmkYzj
zjzjzjhmzjkoaQHwrnMTzqgyzqzqzqgygygyzqzZxkYWzjzjhmgygygygygygygygyzjzjkYWWoUoTzj
zjzjzjhmrnSvrnejMTzqgygygyzqzqgyzqzqgyzqynQfzjzjhmgygygygygygygyzjzjtVoUkYYikYzj
zjzjzjhmzjkoejejzqgygygyzqgyzqgygyzqzqzqzqQfpLzjzjzjzjzjgygygyzjzjdYkYlgQgqQgazj
zjzjzjhmzjzjkoMThggyzqgygygyzqgygygyzqzqBernzjzjzjzjzjzjzjgyzjzjzjzjzjzjRBlgzjzj
zjzjzjhmzjkornMTzqzqzqzqzqgygygygygyzqzqrnzjzjzjzjzjzjzjzjzjzjzjzjzjzjzjzjzjzjzj
zjzjzjzjzjpLHwMTzqgygygygygygygygygygyzqMTrnzjzjUVzjzjzjzjzjzjFEFEFEFEFEFEzjzjXU
zjzjzjzjzjzjrnejzqzqgygygygyzqzqgygyzqBeMTQfzjkoMgzjzjzjzjzjFExKTTVxFEFEFEFEFEXU
zjzjzjhmzjzjzjzjcsMTzqgygygygyzqzqzqzqejrnkoQfQfhmzjhmhmhmhmFExKqiXLanYKVxFEFEXU
zjzjzjhmhmhmhmhmUXMTzqgygygygygyzqzqynzxrnQfQfzjzjzjzjWgQfjfTnYQhwOMOMOMFYVxFEXU
zjzjzjgygygygygyzqzqgygygygygygyMYejrnrnkokoQfQfQfzjQfQfQfrvQfQfJVlGlGlGbZJtFEXU
zjzjzjzjgygygygygygygygygygygygyrIrnrnQfQfQfQfQfQfQfQfzjQfYQYQYQWlokokokFRmUFEXU
zjzjzjzjzjgygygygygygygygygygygyMgzxrnQfQfzjQfQfhmhmzjzjhmhmFExKrMXLanYKmUFEFEXU
zjzjzjzjgygygygygygygygygygygygyMgQfQfzjzjzjQfgyhmzjzjzjzjzjFExKTTQRFEFEFEFEFEXU
zjzjzjgygygygygygygygygyxxgygygyMgQfzjzjzjzjQfgyhmzjzjzjzjzjzjFEFEFEFEFEFEFEFEXU
zjzjzjzjgygygyzjzjgygyzjzjzjzjgyzjzjzjzjzjzjhmhmzjzjzjzjzjzjzjzjzjzjzjzjzjFEzjXU
zjzjzjzjzjzjzjzjzjzjzjzjzjzjzjzjzjzjzjzjzjzjzjzjhmzjzjzjzjzjzjzjzjzjzjzjzjzjzjzj
"}
