"a" = (/turf/simulated/mineral,/area/space)
"c" = (/turf/simulated/floor/plating,/area/space)
"j" = (/turf/simulated/floor/plating{icon_state = "dmg1"},/area/space)
"C" = (/turf/simulated/open,/area/space)
"I" = (/turf/simulated/floor/plating{icon_state = "dmg3"},/area/space)
"Z" = (/turf/simulated/floor/asteroid,/area/space)

(1,1,1) = {"
cccccccccccccccccccccccccccccccccaaaaaaa
cccccccccccccccccccccccccccccccccaaaaaaa
cccccccccccccccccccccccccccccccccaaaaaaa
cccccccccccccccccccccccccccccccccaaaaaaa
cccccccccccccccccccccccccccccccccZaaaaaa
ccccccccccccccccccccccccccccccccccaaaaaa
ccccccccccccccccccccccccccccccccccccccaa
ccccccccccccccccccccccccccccccccccccccaa
ccccccccccccccccccccccccccccccccccccccaa
ccccccccccccccccccccccccccccccccccccccca
ccccccccccccccccccccccccccccccccccccccca
ccccccccccccccccccccccccccccccccccccZZca
ccccccccccccccccccccccccccccccccccccZZca
acccccccccccccccccccccccccccccccccccccca
acccccccccccccccccccccccccccccccccccZZca
acccccccccccccccccccccccccccccccccccccca
acccccccccccccccccccccccccccccccccccaaZa
accccccccccccccccccccccccccccccccccccccc
accccccccccccccccccccccccccccccccccccccc
accccccccccccccccccccccccccccccccccccccc
accccccccccccccccccccccccccccccccccccccc
accccccccccccccccccccccccccccccccccccccc
acccccccccccIccCcCcccccccccccccccccccccc
acccccccccccccCCCCCccccccccccccccccccccc
acccccccccccICCCCCCCcccccccccccccccccccc
acccccccccccCCCCCCCCCccccccccccccccccccc
accccccccccjCCCCCCCCCCcccccccccccccccccc
accccccccccCCCCCCCCCCCcccccccccccccccccc
accccccccccCCCCCCCCCjCcccccccccccccccccc
acccccccccccCCCCCCCIjccccccccccccccccccc
accccccccccccCCCCCCjcccccccccccccccccccc
aZZZccccccccccCCjCCcccccccccccccccccZZZa
accccccccccccccCjjcccccccccccccccccZZZZa
accccccccccccccccccccccccccccccccccZZZaa
acccccccccccccccccccccccccccccccccccZZaa
acccccccccccccccccccccccccccccccccccZZaa
acccccccccccccccccccccccccccccccccZZZaaa
acccccccccZcaaZZZZZZZZccccccccccccZZZaaa
accccccccccaaaaaaaaaZZccccccccccccccZaaa
aaaaaaaaaaaaaaaaaaaaaaaaaaaaaaaaaaaaaaaa
"}
